0nce|once
100ked|looked
100ping|looping
100sely|loosely
10cated|located
10ng|long
111ness|illness
13ut|but
14c|he
14e|he
1arge|large
1ast|last
1ate|late
1ife|life
2ovemment|government
5h0uld|should
5huffling|shuffling
6f|of
77ie|the
7be|the
7hen|then
7here|there
7he|the
7his|this
7le|the
7me|the
a11|all
a6out|about
a7id|and
abelt|a belt
abilitv|ability
abilltv|ability
ablc|able
ableto|able to
aboiit|about
abolit|about
abollt|about
aboming|aborning
aborter|shorter
abotit|about
aboutenough|about enough
abouther|about her
abouti|about i
abouttheir|about their
aboutthem|about them
aboutthe|about the
aboutthis|about this
abouttwice|about twice
abou|about
abovealmost|above almost
aboveaverage|above average
abovementioned|above mentioned
abruptlv|abruptly
absencefor|absence for
absorband|absorb and
abstractedunless|abstracted unless
acccpt|accept
acceptcollect|accept collect
acceptedthat|accepted that
accommodatmg|accommodating
accompamed|accompanied
accotintabilitv|accountability
achefor|ache for
achieyed|achieved
achristmas|a christmas
ackage|package
ackets|jackets
ackground|background
acknife|jacknife
acknowiedgmenn|acknowledgements
acoess|access
acom|acorn
acquaintedbut|acquainted but
acrdss|across
acrossfrom|across from
acte|acre
actingshe|acting she
actioii|action
actionsfirom|actions from
activeduty|active duty
activitywhich|activity which
actuafly|actually
actuallyno|actually no
acually|actually
acudemy|academy
adda|had dad
addifionally|additionally
addrersing|addressing
ade|made
adi|all
adjoum|adjourn
admiii|admin
admiml|admiral
admiwstrators|administrators
adniiral|admiral
adntiral|admiral
adomed|adorned
adriiiral|admiral
adrniml|admiral
adrriinistration|administration
adulterybut|adultery but
adultwhen|adult when
adventureswere|adventures were
aercrpxt|aircraft
afew|a few
affairsnot|affairs not
affairsuch|affair such
affangement|arrangement
affayed|arrayed
affeet|affect
affested|arrested
affiidships|a midships
affived|arrived
affns|arms
affogance|arrogance
aff|all
afier|after
afive|alive
aflernoon|afternoon
aflotment|allotment
aflowed|allowed
aflowing|allowing
afl|all
afmid|afraid
afountain|a fountain
aframedprint|a framed print
afrernoon|afternoon
afriend|a friend
aftaid|afraid
aftemoonone|afternoon one
aftemoons|afternoons
aftemoon|afternoon
afterand|after and
afterbumers|afterburners
afterdinner|after dinner
afternoise|after noise
aftershock|after shock
aftertheir|after their
aftet|after
aftomey|attorney
ag4in|again
agahist|against
agaifi|again
agaiiist|against
agaiii|again
againforgive|again forgive
againfor|again for
againhow|again how
againor|again or
againuntil|again until
agamst|against
agam|again
agarden|a garden
agc|ago
agendapolitics|agenda politics
agente|agent
agewas|age was
agidg|aging
agnificent|significant
agoand|ago and
agohe|ago he
agoright|ago right
agothursday|ago thursday
agowe|ago we
agrecd|agreed
agreedthat|agreed that
agsigmnent|assignment
aguse|abuse
agwn|again
ahd|and
aheady|already
ahnost|almost
ahout|about
ahve|alive
ah|all
ai1|all
aifcrew|aircrew
aiid|and
aiiiiy|army
aiii|am
aiiother|another
aiiswered|answered
aiiswer|answer
aiitopilot|autopilot
aiiy|any
aii|all
aii|an
ailhouse|jailhouse
ail|all
aind|and
ainidst|amidst
ainother|another
ainple|ample
ainused|amused
ain|am
aiqd|and
airbome|airborne
aircrafl|aircraft
aircra|aircraft
aiready|already
airfieldwhat|airfield what
airforceacademy|air force academy
airhome|airborne
airiess|airless
airlifung|airlifting
airlink|air link
airort|airport
airplade|airplane
airplan|airplane
airstrike|air strike
airtcraft|aircraft
airto|air to
airwar|air war
airwort|airworthy
ajackal|a jackal
ajaid|afraid
ajaratt|bajaratt
ajunkie|a junkie
ajury|a jury
alanned|alarmed
alarined|alarmed
alarnung|alarming
alawyer|a lawyer
alcrt|alert
alhout|about
alid|and
alijungle|all jungle
alinost|almost
alivehe|alive he
alivy|alive
allafternoon|all afternoon
allalone|all alone
aller|after
allfunny|all funny
allhands|all hands
allhough|although
allmaybe|all maybe
allpeople|all people
allthat|all that
allthorities|authorities
allthorized|authorized
almostcertain|almost certain
almostmade|almost made
almostsilence|almost silence
alnd|and
alnost|almost
aloiie|alone
aloiig|along
alonc|alone
alonejust|alone just
alongwith|along with
alqne|alone
alrcady|already
alreadysaid|already said
alrigbt|alright
alsowant|also want
altbougb|although
altemated|alternated
altemately|alternately
altemate|alternate
altematives|alternatives
altemative|alternative
alterward|afterward
althoiigh|although
althougli|although
altirude|altitude
aluminurn|aluminum
alwavs|always
alway|always
alwiys|always
alyout|about
alzvays|always
amazeinent|amazement
ambassadot|ambassador
amborne|airborne
ambulancechasing|ambulance chasing
ambularce|ambulance
ambwance|ambulance
amedcana|americana
ameficans|americans
amencan|american
americabank|america bank
americaii|american
americain|american
amoiig|among
amoiint|amount
amold|arnold
amouiit|amount
amplmcation|amplification
amsterlam|amsterdam
amurderer|a murderer
amusin|amusing
am|am
analyzeher|analyze her
anand|an and
ancf|and
anci|and
ancl|and
ancrily|angrily
ancuso|mancuso
anc|and
andafter|and after
andamerican|and american
andand|and and
anda|and a
andblack|and black
anddagger|and dagger
anddeeply|and deeply
andeighties|and eighties
andeveryone|and everyone
andeverything|and everything
andfather|and father
andfell|and fell
andfinally|and finally
andflash|and flash
andfly|and fly
andfound|and found
andglass|and glass
andgoing|and going
andgray|and gray
andhad|and had
andheavy|and heavy
andhis|and his
andhorrible|and horrible
andhow|and how
andhurled|and hurled
andit|and it
andjohn|and john
andjudging|and judging
andjudy|and judy
andlers|handlers
andlooked|and looked
andmirror|and mirror
andmouth|and mouth
andmy|and my
andneeded|and needed
andnoticed|and noticed
andnot|and not
andnow|and now
andno|and no
andphotographs|and photographs
andreleased|and released
andrescue|and rescue
androidbased|android based
andsaw|and saw
andscraping|and scraping
andseek|and seek
andseizure|and seizure
andspanish|and spanish
andstarted|and started
andtape|and tape
andthat|and that
andthen|and then
andtold|and told
andup|and up
andvirtually|and virtually
andwas|and was
andwatched|and watched
andwell|and well
andwhite|and white
andwho|and who
andwith|and with
andworked|and worked
andyour|and your
andyou|and you
anffhing|anything
anfthinjt|anything
angelinaangel|angelina angel
angerrising|anger rising
angffly|angrily
aniber|amber
aniidst|amidst
animales|animals
animalsfood|animals food
animationfrom|animation from
anitnal|animal
anked|thanked
anklc|ankle
anldes|ankles
anned|armed
annies|armies
annload|armload
annnunition|ammunition
annored|armored
announcedin|announced in
anns|arms
annthing|anything
anny|army
anobservation|an observation
anodher|another
anotherdetective|another detective
anotherfew|another few
anothr|another
anri|arm
answeredcould|answered could
answeringservice|answering service
anthentic|authentic
anunmarked|an unmarked
anvo|anyone
anvthing|anything
anvway|anyway
anv|any
anwrican|american
anyanger|any anger
anybow|anyhow
anyextra|any extra
anyining|anything
anylthing|anything
anymoret|anymore
anyrhin|anything
anythingelse|anything else
anythingin|anything in
anyth|anything
anyunderwear|any underwear
anywarm|any warm
anywav|anyway
anywayflash|anyway flash
anywhem|anywhere
anyxyhere|anywhere
aoes|does
aothing|nothing
apacity|capacity
apariments|apartments
apartmenthouse|apartment house
apartnent|apartment
apfil|april
apienty|aplenty
apin|again
apjartment|apartment
apolice|a police
apologks|apologies
appared|appeared
appeafing|appearing
appearancefor|appearance for
appfaring|appearing
appointmerit|appointment
appointnieiit|appointment
appreach|approach
appyoach|approach
apriland|april and
aproach|approach
apsychological|a psychological
apsychologist|a psychologist
ar7n|arm
araved|arrived
araving|arriving
arca|area
architure|architecture
ard|and
arfived|arrived
arger|larger
argiinients|arguments
ariins|arms
arinband|armband
ariound|around
arisk|a risk
aristocraticlooking|aristocratic looking
arkcstone|arkenstone
arkenstonc|arkenstone
arket|market
arkness|darkness
arl|all
armv|army
armyy|army
arnbulance|ambulance
arnior|armor
arnmo|ammo
arnval|arrival
aroiind|around
aropping|dropping
arop|atop
arotmd|around
arouiid|around
aroundin|around in
arourid|around
arrangementhe|arrangement he
arrangenients|arrangements
arrestedfor|arrested for
arrestmg|arresting
arrhy|array
arrnload|armload
arrn|arm
arrrls|arms
arted|started
artfiilly|artfully
articularly|particularly
artic|arctic
artment|apartment
artnies|armies
arxism|marxism
ar|all
asbamed|ashamed
asbriefly|as briefly
ashestos|asbestos
ashington|washington
ashkelon|ashkelon
asidc|aside
askecl|asked
aske|asked
askher|ask her
askingwanting|asking wanting
askingyou|asking you
askin|asking
asldng|asking
aslies|ashes
asmall|as mall
aspbalt|asphalt
asqault|assault
assageway|passageway
assasssm|assassin
assaultand|assault and
asscssmcnt|assessment
assemblingpuzzles|assembling puzzles
assessmenttheir|assessment their
assigrunent|assignment
asslired|assured
assumedwrongly|assumed wrongly
asswne|assume
astemal|asternal
astically|drastically
astonishmentt|astonishment
astraightforward|a straight forward
astrononiical|astronomical
astutel|astutely
aswann|as warm
atall|a tall
atcity|at city
atc|ate
ately|lately
atements|statements
atfirst|at first
atharmless|at harmless
athenistration|administration
atid|and
ational|national
atmies|armies
atomatically|automatically
atopthe|atop the
atound|around
atrangements|arrangements
atready|already
atrick|patrick
atronly|matronly
attach6s|attaches
attach6|attache
attachedin|attached in
attackbend|attack bend
attendmg|attending
attentiod|attention
attfition|attrition
atthe|at the
attitudeproblem|attitude problem
attomeyf|attorney
attomeys|attorneys
attomey|attorney
attorneyand|attorney and
attqck|attack
atttiosphere|atmosphere
atwhere|at where
aubum|auburn
audiencethe|audience the
auegations|allegations
aughing|laughing
augilst|august
auomey|attorney
authenticafion|authentication
authoritythe|authority the
automafically|automatically
automaticafly|automatically
auxilia|auxiliary
au|all
avaiuable|available
averageaverage|average average
averageeverything|average everything
avetage|average
aviationhow|aviation how
aving|having
awakewhat|awake what
awau|away
awav|away
awaya|away a
awayi|away i
awfid|awful
awftd|awful
awhilewatching|awhile watching
awrecked|a wrecked
awricana|americana
azzhole|asshole
babit|habit
babyhoodand|babyhood and
babywhich|baby which
bacil|back
backand|back and
backbefore|back before
backbut|back but
backcround|background
backof|back of
backpedaled|back pedaled
backpedaling|back pedaling
backscater|backseater
backscat|backseat
bacldng|backing
badstuff|bad stuff
baduoom|bathroom
baffacks|barracks
baffantine|ballantine
baffle|battle
bafflingabout|baffling about
baflantine|ballantine
baflet|ballet
bafl|ball
baftwm|bathroom
bahantine|ballantine
bahered|battered
bahstards|bastards
baiance|balance
baiaratt|bajaratt
bair|hair
bajarart|bajaratt
baj|bajaratt
balf|half
ballucinogen|hallucinogen
balmtine|ballantine
balt|halt
bamacle|barnacle
bames|barnes
bamey|barney
bammer|hammer
bams|barns
bamtine|ballantine
bamyard|barnyard
bam|barn
bananatree|banana tree
bandagesand|bandages and
bandbag|handbag
bandsomely|handsomely
banier|barrier
bankersnow|bankers now
bankloan|bank loan
banksgiving|thanksgiving
bappened|happened
barbor|harbor
bard|hard
barebreasted|bare breasted
barldng|barking
barm|harm
barness|harness
barnsthe|barns the
barret|barrel
barsh|harsh
barthat|bar that
bartle|battle
barvest|harvest
basebafl|baseball
basketballsized|basketball sized
baskethall|basketball
bastardlook|bastard look
bastened|hastened
bas|has
bated|hated
batesexcept|bates except
batfle|battle
bathrooii|bathroom
batred|hatred
battefies|batteries
battlcfield|battlefield
battletested|battle tested
bauantines|ballantines
bauled|hauled
baunt|haunt
bave|have
baving|having
bav|bay
bbdy|body
bbecause|because
bcans|beans
bcat|beat
bccamc|became
bccn|been
bcgan|began
bcing|being
bclicve|believe
bcljig|being
bcountry|country
bcsidc|besides
bcst|best
bctwcen|between
bcx|box
beachesmaking|beaches making
beadfirst|headfirst
bealtby|healthy
beand|be and
bearsor|bears or
beart|hart
beatmg|beating
beaufiful|beautiful
beautiffil|beautiful
beautifid|beautiful
beautifula|beautiful a
beautifulstill|beautiful still
beautytall|beauty tall
beaven|heaven
bebanks|be banks
bebiild|behind
bebre|before
becaiise|because
becausein|because in
becauseskin|because skin
becifoom|bedroom
becomeievidence|become evidence
becommg|becoming
bectic|hectic
becwne|became
bedgerow|hedgerow
bedrofl|bedroll
bedsthe|beds the
beeling|heeling
beenat|been at
beena|been a
befbre|before
befefl|befell
befgre|before
befieve|believe
beforeand|before and
beforeflat|before flat
beforethat|before that
befote|before
beftiending|befriending
begaii|began
begfimed|begrimed
beginningfor|beginning for
begundiscreetly|begun discreetly
begunwith|begun with
beher|better
beheve|believe
behigd|behind
behiiid|behind
behindhis|behind his
behindthe|behind the
beian|began
beight|height
beiiiended|befriended
beiiig|being
beinguntil|being until
beinnd|behind
beit|belt
bejustified|be justified
beld|held
believebecause|believe because
believedand|believed and
bellbent|hellbent
bellboystriped|bellboy striped
belm|helm
belni|helm
belowdecks|below decks
belowground|below ground
belowthe|below the
belped|helped
bemard|bernard
bemice|bernice
bemisphere|hemisphere
bemocratic|democratic
bem|hem
beneateh|beneath
benefitthe|benefit the
beoome|become
bepartinent|department
bepn|began
bere|here
berkienr|berkley
beroming|becoming
berself|herself
ber|her
besidesand|besides and
besitancy|hesitancy
bestchance|best chance
bestde|beside
bestselling|best selling
bestwill|best will
betbre|before
betiveen|between
betmyed|betrayed
betterand|better and
betterintimately|better intimately
beturbulence|be turbulence
betwcen|between
betwe4m|between
betweeii|between
beueve|believe
bevoii|beyond
bewhat|be what
beyoiid|beyond
beyondseemed|beyond seemed
bffl|bill
bfick|brick
bfide|bride
bfight|bright
bfim|brim
bfindly|blindly
bfing|bring
bhstered|blistered
biflion|billion
bifls|bills
bifl|bill
bigdobermans|big dobermans
bigfat|big fat
bigh|high
bigsnatch|big snatch
biiilding|building
biisiness|business
biit|but
biizzard|blizzard
billfor|bill for
billthey|bill they
bimself|himself
bim|him
binge|hinge
binted|hinted
biondie|blondie
biond|blond
bippies|hippies
bis|his
bitchhike|hitchhike
bittemess|bitterness
biuy|billy
blackand|black and
blaclchorse|black horse
bladc|blade
blcach|bleach
blced|bleed
blecd|bleed
blewthat|blew that
blieve|believe
blindand|blind and
blis|bus
blit|but
blocldng|blocking
blondic|blondie
blondone|blond one
bloodbaths|blood baths
blooddrops|blood drops
blossonis|blossoms
blowapart|blow apart
bluc|blue
blueand|blue and
bluesapphire|blue sapphire
bluesuit|blue suit
bluffoverlooking|bluff overlooking
bluffsthat|bluffs that
bluffusing|bluff using
bmldmgs|buildings
bmn|been
bniises|bruises
bnng|bring
bnsk|brisk
bntish|british
boardtwo|board two
boastftd|boastful
boathouses|boat houses
boatthey|boat they
boatthe|boat the
boatwas|boat was
boatwhich|boat which
boddies|bodies
bodics|bodies
bodiesbroadcast|bodies broadcast
bodiessimpson|bodies simpson
bodv|body
bodyand|body and
bodyguardkeeper|bodyguard keeper
bofl|boil
bofore|before
boft|bolt
boist|hoist
boiung|boiling
bole|hole
boltmg|bolting
boly|holy
bombrelease|bomb release
bombsthe|bombs the
bome|borne
bomharded|bombarded
bomhardment|bombardment
bomicide|homicide
bom|born
bonefrom|bone from
bonessome|bones some
boniblet|bomblet
bonored|honored
boofprints|hoofprints
bookjammed|book jammed
booniing|booming
boor|boot
boped|hoped
boping|hoping
bordes|hordes
borizon|horizon
bornblets|bomblets
bornbloads|bombloads
borny|horny
borrendous|horrendous
borse|horse
bose|hose
bospital|hospital
bossinan|bossman
bostil|hostile
bostonsounding|boston sounding
botel|hotel
botfi|both
bothunaccountably|both unaccountably
botlier|bother
botter|hotter
bottlcs|bottles
botv|body
bot|hot
boum|bourn
boundfor|bound for
bours|hours
bouse|house
bover|hover
bovs|boys
bov|boy
bowever|however
bowstfings|bowstrings
boyffiend|boyfriend
boysat|boys at
boyyou|boy you
bqv|boy
brandondid|brandon did
brandonthe|brand on the
brassand|brass and
brcak|break
brcathirig|breathing
breakthrougb|break through
breathand|breath and
brentvvood|brentwood
brickbuilt|brick built
briefcaseand|briefcase and
briefidig|briefing
brifliant|brilliant
brightblue|bright blue
briiig|bring
brillance|brilliance
brinuning|brimming
britishsounding|british sounding
broadcastsfrom|broadcasts from
broadshouldered|broad shouldered
broiight|brought
brolderies|broideries
brooklynhad|brooklyn had
brotherstrust|brothers trust
browheaten|browbeaten
brownishblond|brownish blond
brownsaying|brown saying
brownthat|brown that
brtish|british
bruiscs|bruises
brushfire|brush fire
bserved|observed
btake|blake
btfore|before
btit|but
btond|blond
bucketioad|bucketload
buey|huey
bufied|buried
buflalo|buffalo
buflg|building
buge|huge
buhon|button
buh|bull
buiid|build
buildiiig|building
buildiiing|building
buildingonly|building only
buildling|building
bulied|buried
bulishit|bullshit
bulkfills|bulk fills
bulletshaped|bullet shaped
bullshitwhy|bullshit why
buman|human
bumed|burned
bumers|burners
bumer|burner
bumidity|humidity
buming|burning
bumoff|burnoff
bumsides|burnsides
bumside|burnside
bums|burns
bumt|burnt
bundred|hundred
bungered|hungered
buniped|bumped
bunkered|hunkered
bunted|hunted
bununarks|burnmarks
bureaucracyin|bureaucracy in
burled|hurled
burmng|burning
burnedto|burned to
burningfire|burning fire
burried|hurried
burstillg|bursting
burt|hurt
busband|husband
bushand|husband
busiiiess|business
businessas|business as
businesswas|business was
busked|husked
busv|busy
butfinally|but finally
butfirstyou|but first you
butfour|but four
buti|but i
butjust|but just
butmalone|but malone
butnever|but never
butshe|but she
butthen|but then
butthis|but this
butthole|butt hole
butwait|but wait
butwe|but we
buud|build
buushit|bullshit
buv|buy
bwlding|building
bydrophones|hydrophones
byjohn|by john
bynight|by night
bystep|by step
bytaking|by taking
c4lifornia|california
c6nstitution|constitution
cabm|cabin
caf6s|cafes
caf6|cafe
caffier|carrier
caffing|calling
cafled|called
cafling|calling
cafls|calls
cafl|call
cafm|calm
caftle|cattle
cahned|calmed
cahuly|calmly
caii|can
caim|calm
cainped|camped
calendargood|calendar good
calffornia|california
calhn|calm
califomians|californians
califomia|california
californiai|california i
callcd|called
calledi|called i
calle|called
callingi|calling i
calth|health
caludy|calmly
camage|carnage
camc|came
camegie|carnegie
camem|camera
cames|games
camival|carnival
camma|camera
candidatemaybe|candidate maybe
canier|carrier
cani|can i
canjustify|can justify
cannonsselectors|cannon sselectors
cannotnot|cannot not
cantefing|cantering
cany|carry
capfives|captives
capriciousbut|capricious but
captmn|captain
carc|care
cardsand|cards and
careerbroadening|career broadening
carefally|carefully
carefal|careful
carefidly|carefully
carefiil|careful
carefltlly|carefully
careftilly|carefully
careftil|careful
carefufly|carefully
carefuily|carefully
carewhen|care when
carfied|carried
carfuer|carrier
carier|carrier
caringthe|caring the
carlied|carried
carmot|cannot
carnero|camera
carne|came
carolinaended|carolina ended
carolvn|carolyn
carsand|cars and
carsonjenkins|carson jenkins
carth|earth
cartion|carrion
carwas|car was
cascs|cases
caseas|case as
casea|case a
caseremember|case remember
casethat|case that
cashbecause|cash because
casily|easily
castie|castle
caststhose|casts those
casualbout|casual about
catapiilted|catapulted
catapuft|catapult
catchinghisbreath|catching his breath
categon|category
categoriesfor|categories for
catholicnot|catholic not
catholicpeople|catholic people
cating|eating
catne|came
cattlc|cattle
cauing|calling
caumg|calling
cautioii|caution
cavahy|cavalry
cavah|cavalry
cavc|cave
cavems|caverns
cbair|chair
cbanging|changing
cbests|chests
cbicago|chicago
cbristmas|christmas
cbtlstmas|christmas
ccepted|accepted
ccld|cold
cdge|edge
cdmes|comes
cefling|ceiling
cefls|cells
cefl|cell
ceiiter|center
ceiitury|century
ceiit|cent
ceilingwhich|ceiling which
celebrationi|celebration i
celebrityinto|celebrity into
cemeterv|cemetery
centiiry|century
cepted|accepted
certaiii|certain
cessitated|necessitated
cffccts|effects
cfforts|efforts
cff|off
cfied|cried
cfiff|cliff
cfimes|crimes
cf|of
cgmes|comes
chaffer|chapter
chaflenge|challenge
chaging|charging
chaiige|change
chapfer|chapter
characteristicsmost|characteristics most
charitiesand|charities and
charue|charlie
chating|chatting
chauenges|changes
chcvez|chevez
checkg|checking
cheelcs|cheeks
cheney|chaney
cherrywood|cherry wood
cheruhim|cherubim
chessquite|chess quite
chestand|chest and
chestdropping|chest dropping
chffdren|children
chffs|cliffs
chiefthe|chief the
chiirch|church
childhis|child his
childreii|children
childrenand|children and
childrenfrom|children from
chimneyl|chimney
chinawhich|china which
chine|chime
chitd|child
chlannel|channel
chlily|chilly
chllled|chilled
chloryfonn|chloroform
chmber|climber
chmb|climb
chocolat|chocolate
choldng|choking
choppin|chopping
christmastime|christmas time
chromereflected|chrome reflected
chumed|churned
churchand|church and
chwnber|chamber
chyice|choice
cigarcttcs|cigarettes
cigarehe|cigarette
ciiiic|came
ciit|cut
cinly|certainly
circumstailces|circumstances
cise|else
cistem|cistern
citcumstances|circumstances
cither|either
citiesalmost|cities almost
citv|city
cityduring|city during
citystates|city states
citystate|city state
citywide|city wide
ciuld|could
civilan|civilian
clain|claim
classan|class an
classefied|classified
classwhat|class what
clatfered|clattered
clcar|clear
cleall|clean
clearedred|cleared
clectric|electric
clephant|elephant
clevemess|cleverness
clich6s|cliches
clich6|cliche
clicheabout|cliche about
clientsmost|clients most
cliffmoved|cliff moved
clift|cliff
cliinbed|climbed
climw|climbed
clinicand|clinic and
clinicaround|clinic around
cliphoard|clipboard
clippingsall|clippings all
clirfs|cliffs
clmiax|climax
clodles|clothes
cloor|door
clophopper|clodhopper
closc|close
clotes|clothes
cloudwreath|cloud wreath
clubsthat|clubs that
cluded|included
cluding|including
cnees|knees
cne|one
cniising|cruising
cnimpled|crumpled
cnsp|crisp
coarsc|coarse
coatfrom|coat from
codebook|code book
codenamed|code named
codename|code name
codinates|coordinates
coffal|corral
coffce|coffee
coffect|correct
coffec|coffee
coflected|collected
coflection|collection
coflective|collective
cofleges|colleges
coflege|college
cofnmunity|community
coft|colt
cognittve|cognitive
coid|cold
coifld|could
coiicocted|concocted
coiigress|congress
coiild|could
coiintries|countries
coiintry|country
coiirse|course
coiisidered|considered
coiitrol|control
coine|come
coining|coming
coir1puter|computer
coitee|coffee
coiwng|coming
coiylmittee|committee
coldblooded|cold blooded
coldwater|cold water
colighing|coughing
collcct|collect
collectorswhen|collectors when
collegeaged|college age
collegewas|college was
colonelshould|colonel should
colorand|color and
colorftil|colorful
colurrm|column
comball|cornball
combatdark|combat dark
comcob|corncob
comea|cornea
comercutting|corner cutting
comers|corners
comer|corner
comflower|cornflower
comfusion|confusion
comhusk|cornhusk
comiiig|coming
comingfrom|coming from
commancer|commander
commandcr|commander
commanddetonated|command detonated
commanddirected|command directed
commiinity|community
committedwas|committed was
commoii|common
commuiiity|community
comnglate|coming late
comniander|commander
compaiiy|company
companionsthe|companions the
companynot|company not
comparisonin|comparison in
complctcly|completely
complcte|complete
computerbecause|computer because
comradesnot|comrades not
comrtiitted|committed
comsublantcommander|comsublant commander
comy|corny
concemed|concerned
conceming|concerning
concems|concerns
concem|concern
concernbut|concern but
conditionthat|condition that
confeffed|conferred
conferencesomething|conference something
confessionhe|confession he
confidantsno|confidants no
confidenfial|confidential
confldentiality|confidentiality
conflictof|conflict of
congregationthen|congregation then
conic|come
conipany|company
conjugalrights|conjugal rights
conlident|confident
conlinue|continue
conlrols|controls
conmander|commander
conmianders|commanders
conmrence|conference
connnander|commander
conridence|confidence
consciousnessestwo|consciousnesses two
considerin|considering
consldcred|considered
conspiracyand|conspiracy and
consultantsinevitably|consultants inevitably
controfled|controlled
contrsry|controversy
conuminder|commander
conunanded|commanded
conunander|commander
conv4rsation|conversation
convennal|conventional
conversatiori|conversation
convictionso|conviction so
conw|come
coof|cool
cookingfire|cooking fire
coolnessand|coolness and
coordinatcd|coordinated
copemican|copernican
copemicus|copernicus
copkillin|cop killing
copsand|cops and
copyfight|copyright
cordiess|cordless
corfflict|conflict
coriipany|company
cormmitted|committed
corndor|corridor
corne|come
corning|coming
cornmander|commander
cornmand|command
cornmie|commie
cornpanions|companions
cornpany|company
cornputer|computer
coroffected|corrected
corporationand|corporation and
correcfing|correcting
correctshe|correct she
corroboratedthat|corroborated that
corrunanders|commanders
corrupteven|corrupt even
coryie|come
cotage|cottage
cotfid|could
cotiimandos|commandos
cotild|could
cotlid|could
cotmtry|country
cou1d|could
coufier|courier
couid|could
couiitries|countries
couiitry|country
couldanyone|could anyone
couldfall|could fall
couldfeel|could feel
couldfind|could find
coum|could
councfl|council
counry|country
counselbut|counsel but
counselfor|counsel for
counterartillery|counter artillery
counterterror|counter terror
counterthreats|counter threats
countit|count it
countrysideand|countryside and
countrywestern|country western
countway|county
countyhomicide|county homicide
countyjail|county jail
coupic|couple
coursebut|course but
coursethe|course the
courtroomas|courtroom as
courtthat|court that
coutrary|contrary
coveredtwo|covered two
cowd|could
cowhoys|cowboys
cowhoy|cowboy
cptured|captured
crackingand|cracking and
cradies|cradles
cranberrygrapefruit|cranberry grapefruit
crawlin|crawling
crcate|create
crclssed|crossed
creamwhite|cream white
creativewriting|creative writing
credentialsbut|credentials but
crics|cries
criines|crimes
crilile|crime
crinie|crime
crininally|criminally
crirtiinals|criminals
critne|crime
crossand|cross and
crossexamination|cross examination
crotcli|crotch
crtimble|crumble
crtme|crime
crtrhinalist|criminalist
crumblingthat|crumbling that
cryoenic|cryogenic
cspecially|especially
ctarrison|garrison
ctmfton|grafton
cumbing|combing
cuphoard|cupboard
curc|cure
custodymaybe|custody maybe
cuttent|current
cuttin|cutting
cuurious|curious
cvcry|every
cven|even
cwne|came
cwnpground|campground
cxtrcmely|extremely
cybemetic|cybernetic
cycry|every
cycs|eyes
cyen|even
cyes|eyes
cye|eye
d6j5|deja
d6ja|deja
d6tente|detente
daflas|dallas
dainage|damage
dainp|damp
dancemust|dance must
dancingflames|dancing flames
dangemus|dangerous
dangerousthat|dangerous that
daniaged|damaged
danirnit|damnit
danmed|damned
dannaextremely|danna extremely
dapped|clapped
darfing|darting
darkbrown|dark brown
darkgreen|dark green
darkne|darken
darlin|darling
darnmit|damnit
darnp|damp
databut|data but
datc|date
datesusually|dates usually
daugheer|daughter
davs|days
dav|day
daydinner|day dinner
dayjight|daylight
daysand|days and
daysa|days a
daysbut|days but
daysshe|days she
daythat|day that
dazzg|dazzling
dcad|dead
dcath|death
dcccmbcr|december
dcpressurized|depressurized
dcsk|desk
dcveloped|developed
deadand|dead and
deadfor|dead for
deadlyfumes|deadly fumes
deaduntil|dead until
dearjohn|dear john
deatha|death a
deathconservatively|death conservatively
debfis|debris
decemher|december
decidedthat|decided that
decisioneven|decision even
decisionsuntil|decision suntil
deepcover|deep cover
deffly|deftly
defiberately|deliberately
defiwte|defibrillator
dehverymen|deliverymen
delphl|delphi
dentistguy|dentist guy
departinent|department
departmeiit|department
depictiononce|depiction once
depllrtment|department
depositso|deposit so
depressionand|depression and
depument|department
dernonstrated|demonstrated
derstand|understand
designername|designer name
desiny|destiny
desknothing|desk nothing
destinationwas|destination was
destrov|destroy
destructionand|destruction and
detachedfundamentally|detached fundamentally
detailsthe|details the
detait|detail
detemiination|determination
detenses|defenses
detmmned|determined
deucesdrunk|deuces drunk
devclop|develop
developedkept|developed kept
developmeiit|development
developmerit|development
deviceshowever|device show ever
devounng|devouring
dfferent|different
dffferent|different
dfied|dried
dfifted|drifted
dfink|drink
dfipping|dripping
dfiveway|driveway
df|of
dhan|than
dheir|their
dhem|them
dhese|these
dic|die
didand|did and
didbut|did but
didfor|did for
didjust|did just
didwas|did was
diem|them
dien|then
diey|they
diffefing|differing
differeiice|difference
differeiit|different
difficiilt|difficult
difficu|difficult
diflicult|difficult
difmnt|different
diin|dim
diiring|during
dii|did
dilligently|diligently
dimber|climber
dimensionsfifty|dimensions fifty
diplomaticbut|diplomatic but
dippmg|dipping
dircctioil|direction
direat|dream
direcor|director
dirn|dim
diroat|throat
dirtstreaked|dirt streaked
disapprovah|disapproval
disastrousthe|disastrous the
discemed|discerned
discemible|discernible
discredrr|discredit
discussionswhich|discussions which
discussthe|discuss the
diseaseanyway|disease anyway
diseemable|discernible
disgusfing|disgusting
disharment|disbarment
disinfonnation|disinformation
dismemhered|dismembered
disoriedted|disoriented
disposliig|disposing
disregardfor|disregard for
disssed|discussed
distinguisheda|distinguished a
disttacted|distracted
disturbanceor|disturbance or
ditferent|different
ditional|additional
diviiig|diving
divorcesto|divorces to
diwy|divvy
diy|thy
dld|did
dley|they
dlity|duty
dlm|dim
dlscernlble|discernible
dmsmg|dining
dnnk|drink
dnnnming|drumming
dnside|inside
dnutes|minutes
docl1ments|documents
doctorfind|doctor find
doctorsthe|doctors the
documentother|document other
documentsand|documents and
doesjust|does just
doewhich|doe which
doffs|dolls
doflars|dollars
doflar|dollar
doiie|done
doiiig|doing
doinghe|doing he
dojust|do just
dollara|dollar a
dominguez|dominguez
donc|done
donefor|done for
donewhat|done what
donnant|dormant
donnellyasked|donnelly asked
donot|do not
dooi|door
doonvay|doorway
dooriess|doorless
doorlv|poorly
doorsquite|doors quite
doorswood|doors wood
doot|door
doput|do put
dostopped|do stopped
doticed|noticed
doublebang|double bang
douhts|doubts
dovmtown|downtown
dovm|down
dovrn|down
dowii|down
downbecause|down because
downplayed|down played
downtotally|down totally
doyou|do you
dpove|drove
dqmned|damned
dqmn|damn
drafung|drafting
dramage|drainage
drawhacks|drawbacks
dreadftd|dreadful
dressedfor|dressed for
drhiking|drinking
driffing|drifting
drifung|drifting
drltids|druids
drluds|druids
droduct|product
drofte|draft
dropoff|drop off
drovc|drove
drununing|drumming
drv|dry
dssile|missile
dtan|than
dtity|duty
dufl|dull
duing|during
dunkthat|done that
durfm|during
duriiig|during
dutffiffly|dutifully
dutiftil|dutiful
dutv|duty
duu|dull
dwelag|dwelling
dweuinp|dwellings
dwnn|damn
dwnp|damp
dwrs|doors
dysfiinctional|dysfunctional
eacb|each
eace|peace
eachyear|each year
eacli|each
eagemess|eagerness
eagie|eagle
eamed|earned
eamestly|earnestly
eamest|earnest
eamings|earnings
eaming|earning
eams|earns
eam|earn
eaniest|earnest
eariv|early
earlv|early
earlymorning|early morning
earthbom|earthborn
earty|early
easfly|easily
eastcm|eastern
eastemers|easterners
eastemer|easterner
eastem|eastern
easurements|measurements
easv|easy
easyi|easy
eatblowfish|eat blowfish
eavesdroppingthough|eavesdropping though
ecause|because
ecently|recently
echofathometer|echo fathometer
ecognized|recognized
ecoiiomic|economic
ectional|directional
ediently|eventually
ediication|education
educatioii|education
educationthey|education they
eenglish|english
efective|effective
effands|errands
effeet|effect
efficienc|efficiency
efficienfiy|efficiently
effo|effort
efiof|error
eflfort|effort
efore|before
eftorts|efforts
efully|fully
ehambers|chambers
ehcit|elicit
eiery|every
eigar|cigar
eighthorsepower|eight horsepower
eiid|end
eiiglish|english
eiiibarrassing|embarrassing
eiiough|enough
eiitire|entire
eir|their
eitheir|either
eitner|either
elations|relations
elcome|welcome
elcphant|elephant
elecfion|election
elevatoe|elevator
eliminatedkilled|eliminated killed
eliminationthe|elimination the
elligence|intelligence
elose|close
elsc|else
elseby|else by
elsecoming|else coming
elseinadvertently|else inadvertently
elsethe|else the
elsewas|else was
elther|either
embaffassed|embarrassed
emergingfrom|emerging from
emest|ernest
emhers|embers
emie|ernie
emotiontinged|emotion tinged
empathefic|empathetic
emperoi|emperor
empphasis|emphasis
emptv|empty
emselves|themselves
encampmerit|encampment
encouragedbut|encouraged but
encumhered|encumbered
enemyso|enemy so
eneniy|enemy
energv|energy
enfire|entire
engineerseverybody|engineers everybody
engksh|english
englishin|english in
enlistcd|enlisted
enoiigh|enough
enorinously|enormously
enormousespecially|enormous especially
enoughhe|enough he
enou|enough
enterand|enter and
entertam|entertain
entranceway|entrance way
eople|people
epend|depend
episodesof|episodes of
eporters|reporters
eputation|reputation
eqiiipment|equipment
equafly|equally
equency|frequency
equipmeiit|equipment
erazy|crazy
erfect|perfect
erhaps|perhaps
erican|american
eriodically|periodically
erowning|frowning
erstand|understand
ertiasculated|circulated
erverse|reverse
erward|rearward
escapesomehow|escape somehow
especiafly|especially
especiallyfor|especially for
especiauy|especially
especlafly|especially
especlally|especially
essentiafly|essentially
establisb|establish
estiny|destiny
estroy|destroy
etemalize|eternalize
etemal|eternal
ethnicthe|ethnic the
etrayed|betrayed
eturned|turned
etween|between
eurolpean|european
evcrytbing|everything
evcr|ever
eveebody|everybody
eveii|even
evendirectly|even directly
eventlially|eventually
eventuafly|eventually
eveqming|everything
everbody|everybody
everflew|ever flew
everincreasing|ever increasing
everrything|everything
evervthingwas|everything was
everv|every
everyonefaded|everyone faded
everyonehe|everyone he
everythiiig|everything
everythinghow|everything ho
everythingrocks|everything rocks
everythingthe|everything the
everytmng|everything
everywhererelease|everywhere release
evety|every
evideiice|evidence
evidendy|evidently
evldently|evidently
exacdy|exactly
exacfiy|exactly
exarriination|examination
exasperatino|exasperating
exbilarating|exhilarating
exblblt|exhibit
exceflent|excellent
excessivebut|excessive but
exchangednot|exchanged not
excitcment|excitement
excitiing|exciting
excmng|exciting
executionei|executioner
exerrise|exercise
exhatistion|exhaustion
exhausfion|exhaustion
exhaustedthat|exhausted that
exhibitsthe|exhibits the
expcricnce|experience
expcrieticed|experienced
expeiience|expedience
expenences|experiences
experieiice|experience
experiencedwas|experienced was
explaim|explain
explainthere|explain there
explanatiom|explanation
explodeq|exploded
expos6|expose
exprealy|expressly
expwned|explained
extemalization|externalization
extemal|external
extensivcly|extensively
extiltration|exfiltration
extractedftom|extracted from
extteme|extreme
eyebrowswhich|eyebrows which
eyeiashes|eyelashes
eyerything|everything
eyer|ever
eyesdiseases|eyes diseases
eyesnot|eyes not
eyestinging|eye stinging
eyplanation|explanation
f61k|folk
f6et|feet
f7ashed|flashed
facc|face
facealways|face always
facethe|face the
fach|each
facror|factor
factby|fact by
fadier|father
faflen|fallen
fafling|falling
faflout|fallout
fafl|fall
fagade|facade
faiffiffl|faithful
faimess|fairness
faircraft|fair craft
fairhope|fair hope
faithlcss|faithless
faittitul|faithful
fallingjust|falling just
fallwhich|fall which
falselyaccused|falsely accused
faltcred|faltered
famfly|family
famifiar|familiar
familes|families
familythey|family they
familythe|family the
famity|family
famtily|family
famuy|family
faneral|funeral
fanffly|family
faniilv|family
fanner|farmer
fantaff|fantail
fanuly|family
faqade|facade
fardier|farther
fariners|farmers
fariner|farmer
farmworkers|farm workers
farnfliar|fanfair
fartber|farther
fascinafing|fascinating
fascinationalong|fascination along
fascinatio|fascination
fashionforward|fashion forward
fastexternally|fast externally
fasthalls|fastballs
fatauy|fatally
fatber|father
fateftil|fateful
fathcr|father
fatheir|father
fatherwould|father would
fatliei|father
fattier|father
fatuous|famous
fauing|falling
faultv|faulty
favdred|favored
fbere|there
fbey|they
fbe|the
fbl|fbi
fbrk|fork
fbr|for
fccl|feel
fcd|fed
fcels|feels
fcll|fell
fclt|felt
fcrward|forward
fcr|for
fcvcr|fever
fdled|filled
fe1t|felt
feached|reached
febers|fellers
febiruffly|february
febmary|february
febpuary|february
februany|february
februmt|february
fecklessness|recklessness
fecls|feels
fedeml|federal
feedfrom|feed from
feeis|feels
feeland|feel and
feelespecially|feel especially
feelgood|feel good
feeliiig|feeling
feff|fell
feflow|fellow
fefl|fell
fefore|before
feft|felt
fejing|feeling
fellowspartacans|fellow spartans
felonymake|felony make
feltand|felt and
feltthat|felt that
femalehere|female her
femaleyou|female you
fems|ferns
fem|fern
fendersomeone|fender someone
fener|feller
feniale|female
fertuity|fertility
feuers|fellers
feuer|feller
fewdays|few days
fffied|filled
fffl|fill
ffiat|that
ffibgs|things
fficer|officer
ffidge|fridge
ffiendly|friendly
ffiends|friends
ffie|file
ffifious|furious
ffight|flight
ffiled|filled
ffimies|forms
ffim|film
ffing|fling
ffipped|flipped
ffles|files
ffle|file
fflled|filled
fflpped|flipped
ffnd|find
ffoin|from
ffteen|fifteen
ffty|fifty
fhanks|thanks
fhen|then
fhere|there
fhe|the
fhgh|high
fhink|think
fhis|this
fhls|this
fhncy|fancy
fhough|though
fhr|far
fi7esh|fresh
fi7om|from
fiad|had
fiak|flak
fiames|flames
fianc6c|fiancee
fianc6|fiance
fiashers|flashers
fiashing|flashing
fiash|flash
fiattered|flattered
fiave|have
fiaws|flaws
fibrary|library
fiches|riches
ficlds|fields
fidden|ridden
fiders|riders
fidge|ridge
fidiculous|ridiculous
fiding|riding
fidl|full
fids|lids
fid|rid
fieartless|heartless
fieet|fleet
fieid|field
fieldthat|field that
fieshcolored|fleshcolored
fiew|flew
fie|he
fife|five
fife|life
fifflness|fullness
fiffl|fall
fifies|rifles
fifing|firing
fifled|filled
fifle|rifle
fifling|filling
fifl|fill
fifry|fifty
fifteenan|fifteen an
fifteenminute|fifteen minute
fifteensecond|fifteen second
fiftydollar|fifty dollar
fiftysecond|fifty second
fifues|fifties
figare|figure
figbtin|fighting
fighfing|fighting
fightah|fight ah
figh|fight
figiire|figure
figum|figure
figuredrawings|figure drawings
fiick|flick
fiiendship|friendship
fiighten|frighten
fiight|flight
fiiial|final
fiiid|find
fiiie|fine
fiilallzed|finalized
fiill|full
fiimbling|fumbling
fiineral|funeral
fiin|fun
fiirther|further
fiis|his
fiitiire|future
fike|like
filcd|filed
filce|face
filil|full
fillcd|filled
filneral|funeral
filtcrs|filters
fimdmg|funding
fimes|times
fime|time
fimily|firmly
fimny|funny
fimp|limp
fimshed|finished
fimt|first
fim|fun
fim|him
finaey|finally
finafly|finally
financiai|financial
finc|fine
findat|find at
finelooking|fine looking
finged|ringed
fingen|finger
fingerpritits|fingerprints
fingersd|fingers
finmediately|immediately
finnly|firmly
fioat|float
fiom|from
fiont|front
fioor|floor
fiound|found
fipping|ripping
fiqhts|fights
firc|fire
fireanns|firearms
firehousc|firehouse
firetwo|fire two
firin|firm
firmiless|firmness
firom|from
firquency|frequency
firr|fire
firsr|first
firstat|first at
firstbom|firstborn
firstyou|first you
firushed|finished
fisb|fish
fises|rises
fishbeds|fishheads
fishennan|fisherman
fisk|risk
fislitailing|fishtailing
fit7d|find
fither|father
fitrious|furious
fiutes|flutes
fivc|five
fiwlessly|flawlessly
fiw|few
fixeball|fireball
fixmg|fixing
fjrst|first
fkintly|faintly
flady|flatly
flaniiilg|flaming
flarnethrower|flamethrower
flashbums|flashburns
flatiands|flatlands
fleyte|fleet
fle|he
flift|flirt
flightsuch|flight such
flis|his
flnally|finally
flnd|find
floodsmarks|floods marks
floorwas|floor was
floo|floor
flre|fire
flrst|first
flulling|pulling
fluttefing|fluttering
flving|flying
flwnes|flames
flyingi|flying
flyingsaid|flying said
fmally|finally
fmal|final
fmding|finding
fmd|find
fmgemails|fingernails
fmger|finger
fmished|furnished
fmm|from
fmt|first
fnday|friday
fneal|meal
fnend|friend
fne|the
fnght|fright
fning|firing
fnst|first
fnto|into
fntul|fitful
foarning|foaming
focm|form
foc|for
foflowed|followed
foflowing|following
foflows|follows
foflow|follow
fof|for
foia|for a
foiind|found
foiir|four
foilowed|followed
foi|for
folb|folk
foldcr|folder
foldingbutt|folding butt
folh|folk
follcr|follow
followiiig|following
followling|following
fomicate|fornicate
fomi|form
foner|former
fonified|fortified
fonnat|format
fonvard|forward
fooi|foot
foonsh|foolish
fooorst|first
footbafl|football
for7n|form
foraet|forget
forcefields|force fields
fordi|forth
forebead|forehead
forined|formed
forjustice|for justice
forjust|for just
forlom|forlorn
forme|formed
fornier|former
forrnat|format
foshion|fashion
fot|for
fouiid|found
foundand|found and
foundtheir|found their
fountainsknock|fountains knock
foun|found
fourhours|four hours
fourhour|four hour
fourletter|four letter
fourlevel|four level
fourstory|four story
fowning|foaming
fpiends|friends
fpom|from
fpr|for
fqlling|falling
fqr|for
fracturesand|fractures and
frafl|frail
fraine|frame
fratemal|fraternal
fratemity|fraternity
frcing|forcing
frdm|from
freebom|freeborn
freein|free in
freeright|free right
frenchthese|french these
frequencymodulation|frequency modulation
fresbly|freshly
freuently|frequently
frgm|from
friedd|friend
frieiids|friends
friendfies|friendlies
friendimportant|friend important
frightcncd|frightened
frightcried|frightened
frightoned|frightened
froiit|front
froin|from
fromborder|from border
fromdesperation|from desperation
fromseater|frontseater
fromthe|from the
froni|from
frontscater|front seater
fron|from
frorh|from
froro|from
frot|from
frozenframed|frozen framed
frrquency|frequency
frrshwater|fresh water
frust|trust
fsideration|consideration
ftamed|farmed
ftansferred|transferred
ftaps|flaps
ftather|further
ftdler|fuller
fteedom|freedom
ftenzy|frenzy
ftequency|frequency
ftere|there
fter|after
ftesh|fresh
ftffl|full
fticking|fucking
ftiel|fuel
ftifl|full
ftightened|frightened
ftih|full
ftilfillment|fulfillment
ftimbled|fumbled
ftinctioning|functioning
ftinny|funny
ftirdier|further
ftiselage|fuselage
ftitile|futile
ftle|file
ftling|filing
ftl|the
ftmctioning|functioning
ftmel|tunnel
ftmny|funny
ftm|from
ftnd|find
ftngers|fingers
ftnger|finger
ftniously|furiously
ftoin|from
ftom|from
ftonting|fronting
ftot|not
ftowing|throwing
ftozen|frozen
ftre|fire
ftrm|firm
ftrst|first
ftr|for
fttil|full
ftunbled|fumbled
ftustration|frustration
ftuther|further
ftw|few
ft|it
fua|fun
fuccking|fucking
fuckface|fuck face
fuckyou|fuck you
fucldng|fucking
fuelconsuming|fuel consuming
fuends|friends
fuffed|furred
fufly|fully
fufl|full
fulfil|fulfill
fullformat|full format
fultill|fulfill
fumaces|furnaces
fumace|furnace
fumished|furnished
fumishings|furnishings
fumish|furnish
fumiture|furniture
fundameni|fundamental
funier|furrier
funlly|funny
funnybut|funny but
funw|fumes
furdier|further
furnitureall|furniture all
furnitureand|furniture and
furtheir|further
furthermoreand|furthermore and
furtlier|further
fust|just
futu|future
fwnily|family
fwnous|famous
fwst|first
fxcept|except
fxecutioner|executioner
fziend|friend
gainst|against
galaxv|galaxy
gamedallas|game dallas
gamer|garner
gamholed|gamboled
gamishment|garnishment
ganhand|gunhand
garagefast|garage fast
garbagespotted|garbage spotted
gardenframe|garden frame
gardensbunch|gardens bunch
garfison|garrison
gatfing|gatling
gatlier|gather
gatnered|gathered
gavc|gave
gct|get
gdmaced|grimaced
gdmly|grimly
gdnning|grinning
geffing|getting
geiieral|general
gelieve|believe
gencral|general
gendy|gently
geneml|general
genend|general
generafly|generally
geniushe|genius he
geniussomeone|genius someone
genn|germ
gentlcmen|gentlemen
gentleen|gentlemen
gentlemcn|gentlemen
geometiical|geometrical
georgejoined|george join
georgewas|george was
gerinane|germane
gesturewith|gesture with
getand|get and
getdng|getting
getfing|getting
gettiiig|getting
getwinter|get winter
gfievance|grievance
gfin|grin
gfipping|gripping
ghnted|glinted
ghwed|glared
giance|glance
gick|sick
giimace|grimace
gimself|himself
giove|glove
giraffefrom|giraffe from
girlalthough|girl although
girlsa|girls a
girltook|girl took
girt|girl
givefive|give five
giveii|given
givenas|given as
gjance|glance
gjve|give
gladlv|gladly
glassfronted|glass fronted
glassthat|glass that
gleanirfg|gleaning
glewned|gleamed
glidestope|glidescope
gliest|guest
glinmier|glimmer
glirftpse|glimpse
glish|english
glixnmered|glimmered
glooni|gloom
glovc|glove
gmfton|grafton
gmss|grass
gnmace|grimace
gnn|grin
gnp|grip
gnunbled|grumbled
goalof|goal of
gocid|good
gocs|goes
godand|god and
goddainn|goddamn
goddammit|goddamnit
godknows|god knows
godlevel|god level
godnot|god not
goesfrom|goes from
gof|got
goid|gold
goiie|gone
goiiig|going
goin|going
goitia|going
golg|going
gomg|going
gonen|gotten
gorden|golden
gorners|gomers
gotbusiness|got business
govemed|governed
goveming|governing
govemmental|governmental
govemments|governments
govemment|government
govemors|governors
govemor|governor
govem|govern
goveriimeiit|government
governmentrestricted|government restricted
governmerit|government
gqve|gave
gq|go
graceftil|graceful
graduafly|gradually
grandfatherthe|grandfather the
grandinother|grandmother
grandmoeher|grandmother
graphicand|graphic and
gratefill|grateful
gravesites|grave sites
grayyou|gray you
grcat|great
grccn|green
grcek|greek
greenhoms|greenhorns
greenstandby|green standby
griefabsolutely|grief absolutely
grieyed|grieved
griimed|grinned
gririned|grinned
grl|girl
grmmng|grinning
grm|grin
groiind|ground
groiip|group
groining|growing
groqmed|groomed
grouiid|ground
groundbut|ground but
groundsfor|grounds for
groundsheet|ground sheet
groundswaded|grounds waded
groundto|ground to
groupthe|group the
groupwomen|group women
growillg|growing
gsntry|gantry
gtillt|guilt
gtmbelt|gunbelt
gtmned|gunned
gtm|gun
guadalcanal|guadal canal
guardtower|guard tower
gubematorial|gubernatorial
gucss|guess
guessedhad|guessed had
guift|guilt
gumey|gurney
gumnan|gunman
guncamouflage|gun camouflage
gundark|gun dark
gunsand|guns and
gunsthey|guns they
gurumetal|gunmetal
guud|guard
guv|guy
guythe|guy the
gver|over
gwne|game
h6tel|hotel
hacd|had
hackedout|hacked out
hacl|had
hact|had
hadfound|had found
hadgiven|had given
hadhow|had how
hadjust|had just
hadnever|had never
hadtaught|had taught
hadthat|had that
haffy|harry
hafl|hall
haiids|hands
haiid|hand
hairn|bairn
hai|had
halfexpected|half expected
halfivay|halfway
halfremembered|half remembered
hamess|harness
hames|flames
hamiful|harmful
hanaing|hanging
handafter|hand after
handedand|handed and
handholding|hand holding
handso|hand so
handyif|handy if
hanned|harmed
happeiied|happened
happeninq|happening
happenin|happening
har7nless|harmless
hardgy|hardly
hardof|hard of
harhot|harbor
harinless|harmless
harldng|harking
harrnless|harmless
hartn|harm
haryn|harm
hasfavored|has favored
hastard|bastard
hatcheck|hat check
hatever|hat ever
hatftvay|halfway
havc|have
havethey|have they
haveyouheard|have you heard
haveyou|have you
haviiig|having
hav|have
hawthome|hawthorne
haybam|haybarn
hazardousduty|hazardous duty
hcad|head
hcard|heard
hcavv|heavy
hcavy|heavy
hck|lick
hcld|held
hclped|helped
hcrc|here
hcre|here
hcr|her
hcur|hour
hc|he
hdr|her
heach|beach
headcluarters|headquarters
headlarnp|headlamp
headquartersand|headquarters and
headquartersat|headquarters at
headwere|head were
heaft|heart
heaied|healed
healtby|healthy
healtb|health
heanng|hearing
heanswered|he answered
hearingsthere|hearings there
heartbum|heartburn
heartheat|heartbeat
heatbut|heat but
heatexhausted|heat exhausted
heatskin|heat skin
heawng|hearing
heaw|heavy
hecaught|he caught
heceby|hereby
hecein|herein
hecewith|herewith
heen|been
hefelt|he felt
heffnit|hermit
heff|hell
hefl|hell
hefore|before
hefound|he found
heftnet|helmet
heginning|beginning
hehaddiscardedhisjacket|he had discarded his jacket
hehad|he had
heheard|he heard
hehnets|helmets
heh|hell
heimet|helmet
heings|beings
helicopterpilots|helicopter pilots
helniets|helmets
helooked|he looked
helpftd|helpful
helplcss|helpless
hel|hell
hemade|he made
hemandez|hernandez
hemophiliaexcept|hemophilia except
herand|her and
herc|here
hereaved|bereaved
hereither|her either
heremembered|he remembered
herface|her face
herfather|her father
herfinal|her final
hergypsy|her gypsy
herher|her her
heridentifications|her identifications
herinit|hermit
herjacket|her jacket
herjaws|her jaws
herjaw|her jaw
herjeans|her jeans
hernot|her not
heror|her or
herries|berries
hersand|hers and
herseemed|her seemed
herseft|herself
herselfdriving|herself driving
hertnit|hermit
herwhich|her which
hese|these
hesirated|hesitated
hesitatiod|hesitation
hesitationdown|hesitation down
hest|best
hes|lies
hetp|help
hetried|he tried
hetween|between
heul|hell
heu|hell
hewas|he was
hewatched|he watched
hewentoutofhismind|he went out of his mind
heybig|hey big
heygarywhat|hey gary what
hfe|life
hffle|little
hflls|hills
hflt|hilt
hfr|her
hfted|lifted
hftn|him
hi5|his
hich|which
hiddenby|hidden by
hidebut|hide but
hiendly|friendly
hiflsborough|hillsborough
hifls|hills
hifl|hill
hift|hilt
hig11er|higher
higb|high
highschooler|high schooler
hih|hill
hiiman|human
hiimseff|himself
hiindred|hundred
hijin|him
hildren|children
hile|while
hilge|bilge
hilling|hitting
hiln|him
himabout|him about
himafter|him after
himalthough|him although
himand|him and
himdespite|him despite
himdreds|hundreds
himelf|himself
himhad|him had
himin|him in
himliterallyhe|him literally he
himnothing|him nothing
himokay|him okay
himonthly|bimonthly
himsclf|himself
himseft|himself
himselfas|himself as
himselfa|himself a
himselfstands|himself stands
himsell|himself
himselp|himself
himsel|himself
himse|himself
himthat|him that
himthis|him this
himtiming|him timing
himwas|him was
himwho|him who
hinden|hidden
hiniself|himself
hink|think
hinl|him
hinr|him
hinself|himself
hintelligence|intelligence
hinx|him
hirii|him
hirmelf|herself
hirn|him
hirti|him
hiscock|his cock
hisect|insect
hisface|his face
hisfather|his father
hiside|inside
hisis|his is
hisjacket|his jacket
hisjaw|his jaw
hisjurisdiction|his jurisdiction
hismother|his mother
hispection|inspection
hisrestraint|his restraint
histantly|instantly
histened|listened
histening|listening
historythere|history there
hiswrist|his wrist
his|his
hitchhlker|hitchhiker
hithad|hit had
hitil|him
hitplanes|hit planes
hitsthe|hits the
hittinj|hitting
hiul|him
hiu|hill
hivpositive|hiv positive
hixn|him
hkd|like
hke|like
hkling|hiding
hlind|blind
hlm|him
hls|his
hmgine|imagine
hmiself|himself
hmmle|handle
hmr|hair
hnages|images
hne|line
hnn|him
hoaxbut|hoax but
hoiirs|hours
hoiir|hour
hoiise|house
holc|hole
holdwhich|hold which
holierthan|holier than
holise|house
homcplate|homeplate
homc|home
homecorriing|homecoming
homeno|home no
homeplatc|homeplate
homewhich|home which
hompipes|hornpipes
homs|horns
homy|horny
hom|horn
honestto|honest to
honie|home
hoofpfints|hoofprints
hoom|room
hootchcs|hootches
hopedwhat|hoped what
hopeftilly|hopefully
hopelesswe|hopeless we
hopesomewhere|hope somewhere
hopeyou|hope you
horida|florida
horne|home
horrciidous|horrendous
horrifiedmaybe|horrified maybe
horsesgetting|horses getting
hospitalso|hospital so
hospi|hospital
hostagesand|hostages and
hotelappropriated|hotel appropriated
hoteljust|hotel just
hoth|both
hotisc|house
hotise|house
hotjet|hot jet
hottom|bottom
hottse|house
houir|hour
houlas|hours
houng|young
hourslocal|hours local
hourthen|hour then
hourtwo|hour two
hourwhile|hour while
housc|house
houseguest|house guest
houseif|house if
houseon|house on
housethe|house the
housewould|house would
howbad|how bad
howmen|bowman
howstrings|bowstrings
hoys|boys
hps|lips
hp|lip
hqd|had
hrain|brain
hst|list
htig|hug
httie|little
httle|little
hu7t|hurt
huffy|hurry
huiidred|hundred
humaii|human
humillated|humiliated
humminghirds|hummingbirds
hundreddegree|hundred degree
hundreddollar|hundred dollar
hundredwould|hundred would
hundreth|hundredth
hungrv|hungry
hunied|hurried
hunterkiller|hunter killer
huntin|hunting
hununing|humming
hunzans|humans
hun|him
hurch|church
hurfied|hurried
huriied|hurried
hurniliation|humiliation
hurrieti|hurried
hurtftil|hurtful
hurty|hurry
husbandthen|husband then
hushand|husband
husldness|huskiness
hutit|hunt
hwsborough|hillsborough
hydraubc|hydraulic
hyperhole|hyperbole
hypocrisyused|hypocrisy used
i4appening|happening
iady|lady
iakes|takes
ianguage|language
ianterns|lanterns
iast|last
ibat|that
ibere|there
ibey|they
ibe|the
ibis|this
icast|least
icaves|leaves
icaving|leaving
icelandunited|iceland united
ich|which
icngdoms|kingdoms
icnown|known
icnses|lenses
icns|lens
icrazy|i crazy
icss|less
ictter|letter
ictting|letting
ictures|pictures
ict|let
idcards|id cards
iddress|address
identitv|identity
identtfication|identification
idfing|lifting
idiors|idiots
idnd|kind
idngdoms|kingdoms
idssed|kissed
idtchen|kitchen
iearned|learned
ieast|least
ieaving|leaving
ieft|left
iends|friends
iere|there
iess|less
ietnam|vietnam
iet|let
iface|i face
ifa|if a
ife|life
iffeparable|irreparable
iffe|life
iffies|fifties
iffted|lifted
ifhis|if his
ifim|him
ifit|if it
ifi|if i
iflinois|illinois
iflusion|illusion
iflustrated|illustrated
ifl|ill
ifoffering|if offering
ifonly|if only
iforget|i forget
ifound|i found
ifshe|if she
ifsomeone|if someone
ifthis|if this
ifwe|if we
ifyou|if you
igade|brigade
ighway|highway
igiicred|ignored
igngdoms|kingdoms
ignorethe|ignore the
ihat|that
ihe|the
ihformation|information
ihorts|shorts
ih|ill
iiame|name
iiatioiial|national
iiatural|natural
iiature|nature
iiear|near
iiecessary|necessary
iieeded|needed
iieeds|needs
iieed|need
iiever|never
iiew|new
iiext|next
iife|life
iighten|lighten
iiiadniissible|inadmissible
iiicreased|increased
iiicrease|increase
iiide|hide
iiidividual|individual
iiidustry|industry
iiieliitig|melting
iiight|night
iiiider|under
iiinp|limp
iiiside|inside
iiis|his
iiiterest|interest
iiito|into
iiivolved|involved
iiiy|my
iii|in
iijonients|moments
iikely|likely
iike|like
iimbs|limbs
iinagination|imagination
iinder|under
iing|thing
iinpatience|impatience
iintil|until
iior|nor
iiothiiig|nothing
iiot|not
iiow|now
iio|no
iipon|upon
iip|up
iised|used
iise|use
iisiially|usually
iis|us
iitde|little
iiuitiber|number
iiumber|number
iive|five
iive|live
ijust|i just
ikely|likely
iknow|i know
ilad|had
ilealing|healing
ilese|these
ile|the
ilfe|life
ilis|this
ili|in
ilke|like
illuritinated|illuminated|
ilough|though
ilove|i love
iltde|little
imagme|imagine
imcvw|know
imean|i mean
imediately|immediately
imee|knee
imere|there
imew|knew
imew|know
ime|line
immechately|immediately
imniediately|immediately
imnwdiatel|immediately
imortant|important
imowing|knowing
imow|know
impefial|imperial
impendmg|impending
imperwnate|impersonate
imponant|important
importaiit|important
importantand|important and
impossiblefor|impossible for
impossiblewhich|impossible which
improvedthough|improved though
imrnediateiy|immediately
imsaster|disaster
imself|himself
inade|made
inakes|makes
inarvellously|marvelously
inat|what
inay|may
inberited|inherited
inbibit|inhibit
inbom|inborn
incamate|incarnate
incliiding|including
incompletc|incomplete
incomprebensible|incomprehensible
inconsistentand|inconsistent and
incuriousbut|incurious but
indeedand|indeed and
indicatmg|indicating
indidivual|individual
indiistry|industry
indispensableand|indispensable and
individiial|individual
indolentseeming|indolent seeming
ind|and
ineal|meal
inect|meet
inentification|identification
inevitablybecome|inevitably become
infamousdiplomats|infamous diplomats
infemal|infernal
infidelsand|infidels and
infiront|infront
infiuence|influence
infoffnation|information
informazioni|information
inforrn|inform
infront|in front
inhoard|inboard
ininctively|instinctively
ininute|minute
iniposed|imposed
inirror|mirror
injackson|in jackson
injuriesthat|injuries that
injusticeassociating|in justice associating
inlav|inlay
inlieritatice|inheritance
inmiediately|immediately
inncr|inner
inning|running
innkccper|innkeeper
innnediately|immediately
innocentthat|innocent that
inoinent|moment
inoming|incoming
inoney|money
inore|more
inportance|importance
inquiryor|inquiry or
inquirywas|inquiry was
inrriate|initiate
inructions|instructions
insensltlvltv|insensitivity
insfinctively|instinctively
insfinct|instinct
insiae|inside
insidethat|inside that
insidethe|inside the
insoninia|insomnia
inspecn|inspection
instafled|installed
instancejust|instance just
instantan|instant an
instantbut|instant but
instingtively|instinctively
instnictors|instructors
instrbctions|instructions
instructionbut|instruction but
instructorpilot|instructor pilot
intedected|interjected
inteffogation|interrogation
inteflectual|intellectual
intefligence|intelligence
intellectualnot|intellectual not
intelligentnot|intelligent not
intemally|internally
intemal|internal
intemational|international
intemet|internet
intensewhen|intense when
intensivecare|intensive care
interesdng|interesting
interpreterand|interpreter and
intertainment|entertainment
intonationevery|intonation every
intothe|into the
intuitionthat|intuition that
inunediately|immediately
inuriigration|immigration
inutes|minutes
inuwuctions|introductions
investigahon|investigation
invesugations|investigations
involvementand|involvement and
inwashington|in washington
iny|any
ioke|joke
iolportantly|importantly
iomed|joined
ionger|longer
iong|long
iooked|looked
iook|look
ioti|ion
iot|lot
ioud|loud
iower|lower
ioy|joy
iplomats|diplomats
ipresume|i presume
irdrnediately|immediately
irection|direction
ire|are
iriside|inside
iristinct|instinct
irivestigation|investigation
iri|in
irtsulting|insulting
irwne|money
isffteen|is fifteen
isflickering|is flickering
isjust|is just
islanb|island
islandgovernment|island government
islandoh|island oh
islandsthe|islands the
islandthe|island the
islandwhere|island where
islandwhich|island which
isposal|disposal
ispushed|is pushed
issiie|issue
istarted|i started
istechnically|is technically
istepped|i stepped
isthat|is that
isthese|is these
ist|1st
iswell|is well
iswhat|is what
isyourself|is yourself
isyou|is you
itafter|it after
italianand|italian and
italianreally|italian really
itallan|it allan
italyat|italy at
itbut|it but
itelligence|intelligence
itemspackages|items packages
itespecially|it especially
itfrom|it from
itgive|it give
ithinkhe|i think he
ithought|i thought
itich|inch
iting|waiting
itission|mission
itis|it is
ititimidatioli|intimidation
itjust|it just
itknew|it knew
itmnense|immense
itmost|it most
itnages|images
itold|i told
itook|i took
itpainted|it painted
itregular|irregular
itr|its
itseft|itself
itseip|itself
itselfor|itself or
itselfthat|itself that
itsell|itself
itstead|it stead
itthat|it that
itthere|it there
ittommy|it tommy
itwas|it was
itwhite|it white
itwho|it who
itwould|it would
itwriting|it writing
iuany|many
iudge|judge
iunged|lunged
iustice|justice
iust|just
ius|his
iu|ill
ivhat|what
ivhich|which
ivilhat|all that
ivill|will
ivind|wind
ivorywhite|ivory white
iwalked|i walked
iwanted|i wanted
iwant|i want
iwas|i was
iwill|i will
iwon|i won
ixt|let
iyas|was
iying|lying
izirls|girls
jabhered|jabbered
jacketbut|jacket but
jackrabbited|jack rabbited
jad|jail
jafl|jail
jailerswhich|jailers which
jailno|jail no
jaines|james
jamuary|january
janubry|january
janum|january
jarhouse|jailhouse
jauhouse|jailhouse
jau|jail
jawcracking|jaw cracking
jawhoning|jawboning
jaxuary|january
jbr|for
jecp|jeep
jected|objected
jeffemn|jefferson
jerldn|jerkin
jewehy|jewelry
jewishand|jewish and
jfferson|jefferson
jfkan|jfk an
jhn|jim
jiist|just
jiitters|jitters
jimuary|january
jinl|jim
jistice|justice
jjust|just
jkom|from
jmuimy|january
jobsomebody|job somebody
johii|john
johnsongrass|johnson grass
joh|job
joily|jolly
jokmg|joking
jolning|joining
jom|from
jom|join
jotirnal|journal
joumalism|journalism
joumalist|journalist
joumal|journal
joumey|journey
jourth|fourth
jowmey|journey
jpnk|junk
jrom|from
judgeand|judge and
judgmentleaving|judgment leaving
judv|judy
juicesand|juices and
jurorhis|juror his
jurorsat|juror sat
jurry|jury
jurymost|jury most
jurynot|jury not
justsome|just some
justwish|just wish
jvhy|why
kaow|know
karcinko|marchenko
kcl4|kcia
kdge|ledge
kdow|know
keepei|keeper
keeplng|keeping
kemel|kernel
kemember|remember
kevs|keys
kffled|killed
kflled|killed
kgled|killed
khew|knew
kicldng|kicking
kidand|kid and
kidbarely|kid barely
kidbelieve|kid believe
kidcling|kidding
kiddic|kiddie
kidfly|kid fly
kidglove|kid glove
kidno|kid no
kidsbecause|kids because
kiffings|killings
kifled|killed
kifl|kill
kihs|kills
kiiew|knew
kiiid|kind
kiiied|killed
kiiow|know
killedhad|killed had
killerhad|killer had
killerwhich|killer which
killsfirst|kills first
killthem|kill them
kilometre|kilometer
kindthat|kind that
kined|killed
kingdoni|kingdom
kinwhich|kin which
kirid|kind
kissingsoftly|kissing softly
kitchenignoring|kitchen ignoring
kitfatigues|kit fatigues
kiu|kill
kix|kill
klcked|kicked
kld|kid
kleinpaused|klein paused
kleinwas|klein was
kmghts|knights
kmg|king
kmship|kinship
kmt|kill
kncw|knew
knenn|knew
knewbetter|knew better
knewfrom|knew from
knewnot|knew not
knewor|knew or
knewvirtually|knew virtually
knewwas|knew was
knewwhat|knew what
knffe|knife
knifepoint|knife point
knocldng|knocking
knosw|know
knovv|know
knowalthough|know although
knowand|know and
knowanswer|know answer
knowbut|know but
knowevidence|know evidence
knowher|know her
knowi|know i
knowjust|know just
knowkind|know kind
knowledgeespecially|knowledge especially
knowmajor|know major
knowresearch|know research
knowsomehow|know somehow
knowto|know to
knowwould|know would
knuckledragging|knuckle dragging
kofea|korea
korcoms|koreans
korran|korean
kriows|knows
ktss|kiss
kuled|killed
kvear|wear
l23|123
l4doking|looking
laame|name
laboratoryto|laboratory to
laborator|laboratory
laborrelated|labor related
ladyworks|lady works
laier|later
laiid|land
laimseft|himself
lainp|lamp
lamself|himself
lantem|lantern
lanuage|language
lanuary|january
laotianjungle|laotian jungle
larce|large
lasfing|lasting
lastbom|lastborn
lastditch|last ditch
latc|late
latestflaps|latest flaps
latet|later
laugb|laugh
lauihed|laughed
lave|have
lawhreaker|lawbreaker
lawyersparticularly|lawyers particularly
lawye|lawyer
lben|then
lbere|there
lbe|the
lcd|led
lcft|left
lcnot|knot
lcvcl|level
ldcked|kicked
ldds|kids
ldll|kill
ldnd|kind
ldngdom|kingdom
ldss|kiss
leaderand|leader and
lealied|leaned
leamed|learned
leaming|learning
leams|learns
leam|learn
leane|leaned
leastyou|least you
leathemeck|leatherneck
leatherand|leather and
leavesit|leave sit
leawe|leave
leaw|leave
lectem|lectern
ledgesbut|ledges but
ledgeswas|ledges was
leff|left
lefr|left
lefs|lets
leftforgiven|left forgiven
leill|kill
lelt|left
lerusalem|jerusalem
letlial|lethal
lettera|letter a
levcl|level
lffe|life
lgve|love
lhas|has
lhe|the
liad|had
liappened|happened
liard|hard
liaused|paused
liberalhating|liberal hating
licenseearly|license early
licldng|licking
licrself|herself
licutenant|lieutenant
lic|lie
lieiitenant|lieutenant
lield|held
lieople|people
liers|hers
lieutenrmt|lieutenant
lifeor|life or
liffing|lifting
liffle|little
lifr|lift
liftcd|lifted
lifung|lifting
ligbt|light
lightand|light and
lightattack|light attack
lightbecause|light because
liiies|lines
liiie|line
likc|like
likeand|like and
likeare|like are
likea|like a
likei|like i
likelihoodron|likelihood ron
likeno|like no
liki|like
lik|like
lilisteners|listeners
lilke|like
limeupholstered|lime upholstered
limitsbut|limits but
linavenged|unavenged
lincoin|lincoln
linc|line
linder|under
lineabreast|line abreast
linencovered|linen covered
linfortunately|unfortunately
linle|little
linsteady|unsteady
linters|lintels
lionor|honor
lionswith|lions with
listenfd|listened
listenink|listening
lis|us
litanyhow|lit anyhow
litde|little
literallyand|literally and
litfie|little
litfle|little
lithographswho|lithographs who
litically|politically
litle|little
littic|little
littie|little
littje|little
littlefrozen|little frozen
littlegirl|little girl
liule|little
liumaii|human
liviiig|living
livingvery|living very
liyperspace|hyperspace
ljntil|until
ljpon|upon
lke|like
llights|lights
llight|light
llils|this
llimits|limits
llkc|like
lls|us
lltrle|little
lmee|knee
lmew|knew
lmm|1mm
lmowing|knowing
lmpulse|impulse
lnstaiii3tion|installation
lntruder|intruder
lnvasion|invasion
ln|in
loadingit|loading it
loatlied|loathed
local|local
locatio|location
lockbackjobs|lock back jobs
loiiger|longer
loiig|long
loking|looking
londonthat|london that
lonelv|lonely
lonesomefor|lonesome for
longerjust|longer just
lonqer|longer
lookedfor|looked for
lookfor|look for
lookiiig|looking
lookin|looking
lookyou|look you
loolang|looking
looldng|looking
loonw|loomed
loosefitting|loose fitting
lote|love
loued|lolled
lovc|love
lovednot|loved not
lovernaking|lovemaking
lovestruck|love struck
lowestranking|lowest ranking
lso|also
ltjust|it just
lt|it
lumhered|lumbered
lunbs|limbs
lvrson|person
lwo|two
lymg|lying
m6lange|melange
mad6|made
madain|madam
madc|made
madher|mad her
maffy|marry
mafing|mating
mafl|mail
maftm|matter
magazinefiction|magazine fiction
magluder|magruder
magnficent|magnificent
magniticent|magnificent
mahoganycolored|mahogany colored
maiiy|many
maii|man
mailno|mail no
mailso|mail so
maintenant|maintenance
majesticaby|majestically
majestv|majesty
makcs|makes
makc|make
makebelieve|make believe
makejokes|make jokes
makeover|make over
makeyou|make you
makiiig|making
maldng|making
maleswas|males was
malfunctio|malfunction
malting|making
mamnioth|mammoth
mamtam|maintain
manher|man her
manied|married
manuevered|maneuvered
manv|many
manwaring|man waring
manwho|man who
mapum|magnum
marche|marched
marcinko|marchenko
marinostarted|marino started
markethad|market had
marldng|marking
marriagesand|marriages and
marriedcorrection|married correction
martied|married
marvellous|marvelous
masksand|masks and
masldng|masking
mastcr|master
mastergovernorglares|master governor glares
mat6riel|materiel
matemally|maternally
materialdna|material dna
matineesand|matinees and
mattcred|mattered
matteredsweat|mattered sweat
matterhere|matter here
mattresswould|mattress would
mavbe|maybe
mav|may
maybc|maybe
maybeplease|maybe please
maybeyou|maybe you
mayhe|maybe
mcan|mean
mcat|meat
mchned|inclined
mcmber|member
mcss|mess
mc|me
mdio|radio
mdl|mill
meaiis|means
meaii|mean
meanbut|mean but
meaningespecially|meaning especially
meani|mean i
meanlooking|mean looking
meanswhat|means what
meanwere|mean were
meanwhere|mean where
meanwhy|mean why
meanyou|mean you
meatyface|meaty face
mecoy|mccoy
mecting|meeting
medicationjust|medication just
meec|meet
meetiiig|meeting
mehow|me how
meii|men
meircinko|marchenko
mel6e|melee
mele6|melee
memberswere|members were
memberswhich|members which
memhers|members
memher|member
memofies|memories
memones|memories
memorydimpled|memory dimpled
memosyou|memos you
menare|men are
mengathered|men gathered
meone|someone
meprobably|me probably
meraory|memory
mercifidly|mercifully
mercifid|merciful
mericans|americans
merican|american
mernory|memory
mesage|message
mesmefized|mesmerized
mesomeone|me someone
mesomething|me something
messag4is|messages
messagethe|message the
metchant|merchant
mething|something
meticulouselegant|meticulous elegant
meticulouslyfashioned|meticulously fashioned
meyou|me you
mey|they
mfant|infant
mfflions|millions
mfiitary|military
mfld|mild
mfleposts|mileposts
mflitary|military
mflking|milking
mfll|mill
mfonnation|information
mght|night
miaht|might
mich|which
midaftemoon|midafternoon
middleclass|middle class
middlemanwas|middleman was
midmoming|midmorning
mieht|might
mifforlike|mirrorlike
miffors|mirrors
miffor|mirror
miflions|millions
miflion|million
mightand|might and
mighthave|might have
mightjust|might just
migt|might
mig|mig
miich|much
miiid|mind
miiiutes|minutes
miisic|music
miist|must
militafty|military
milldng|milking
millioii|million
mimites|minutes
mindanswering|mind answering
mindanything|mind anything
mindfrom|mind from
mindreaders|mind readers
mindwhich|mind which
miniffidge|minifridge
miniites|minutes
ministerfrom|minister from
minisy|ministry
minneapolisand|minneapolis and
minneapolisjust|minneapolis just
minneapoliswhich|minneapolis which
minorty|minority
mintite|minute
minuteswhat|minutes what
minutewhich|minute which
miraclcs|miracles
mirie|mine
miror|mirror
mirried|married
mirrot|mirror
mirthiessly|mirthlessly
mirtor|mirror
misbap|mishap
miscry|misery
misgovem|misgovern
misouri|missouri
missince|missing
missingand|missing and
missingbut|missing but
missingpersons|missing persons
missionqualified|mission qualified
mississi|mississippi
missle|missile
missm9|missing
mivbe|maybe
mjured|injured
mlat|what
mled|filled
mlich|much
mlschlevous|mischievous
mlssmg|missing
mmd|mind
mnutes|minutes
mobil|mobile
mocldng|mocking
modemism|modernism
modemity|modernity
modemization|modernization
moderii|modern
modier|mother
moffow|morrow
mofioning|motioning
moiiey|money
moiiths|months
moinents|moments
moiring|morning
momedt|moment
momeiit|moment
momenhrily|momentarily
momentsno|moments no
momings|mornings
moming|morning
momng|morning
monasteties|monasteries
mondaymorning|monday morning
monev|money
moneyand|money and
moneydata|money data
moneywas|money was
monient|moment
monimy|mommy
monkcvs|monkeys
monstees|monsters
montb|month
monthsonly|months only
monthssince|months since
monung|morning
morc|more
morebecause|more because
morerapid|more rapid
moriient|moment
mormng|morning
mornents|moments
mornent|moment
morningamerica|morning america
morningno|morning no
mornroy|mommy
morn|mom
mororning|morning
mosthow|most how
mostlv|mostly
mostthe|most the
motheror|mother or
motherwhen|mother when
motiod|motion
motiotiless|motionless
motivebut|motive but
motmd|mound
motnents|moments
moumed|mourned
mouming|mourning
mountams|mountains
moustache|mustache
mouthand|mouth and
moutheverything|mouth everything
moutil|mouth
movc|move
moveditup|moved it up
movingas|moving as
movmg|moving
movth|mouth
mpid|rapid
mportant|important
mpulsive|impulsive
mqnaged|managed
mqny|many
mqn|man
mside|inside
mstant|instant
mtact|intact
mtcro|micro
mtelligent|intelligent
mtil|until
mtncate|intricate
mtnds|minds
mto|into
mucb|much
muchhonored|much honored
muchnoise|much noise
muchsought|much sought
muchthe|much the
muiti|multi
muk|milk
mumiured|murmured
mummystyle|mummy style
murdercaptain|murder captain
murdershad|murders had
muriiiured|murmured
murmurecl|murmured
murrnur|murmur
murteretl|murdered
murtnured|murmured
museumof|museum of
museumquality|museum quality
mutualfriend|mutual friend
mvself|myself
mv|my
mwd|stood
mycar|my car
myface|my face
myfather|my father
myfiads|myriads
myfriend|my friend
myfucking|my fucking
mygood|my good
myht|might
myjury|my jury
mynad|myriad
mypain|my pain
myrole|my role
mysclt|myself
myse4f|myself
myseff|myself
myseip|myself
myselfto|myself to
mysell|myself
myselp|myself
mysterywhich|mystery which
n0t|not
n6t|not
nafled|nailed
nafls|nails
naiicv|naive
nailsright|nails right
nailsthe|nails the
nairne|name
naity|nasty
naivet6|naivete
namc|name
namebut|name but
nameit|name it
nardly|hardly
narrowcast|narrow cast
nassed|missed
nastybitch|nasty bitch
nastyjob|nasty job
nas|has
natiiral|natural
natiire|nature
natioiial|national
natm|nature
naturafly|naturally
naturejust|nature just
naving|having
nblished|published
ncar|near
ncck|neck
ncrvous|nervous
ndifferent|different
neady|neatly
necd|need
necesmffly|necessarily
necessitiesundergarments|necessities undergarments
neede|needed
needleswere|needles were
negativeso|negative so
neighborhooddid|neighborhood did
neitheir|neither
nen|then
neptiiiie|neptune
netftds|netfulls
neutrat|neutral
nevenheless|nevertheless
nevernever|never never
neversuspected|never suspected
neverwhen|never when
nevex|never
nevspaper|newspaper
newbom|newborn
newcorners|newcomers
newhorn|newborn
newsfor|news for
newsgatherers|news gatherers
newspapersthe|newspapers the
newsthings|news things
newyork|new york
nextdoor|next door
nexthigher|next higher
nexthighest|next highest
nextload|next load
nextmorning|next morning
nextthe|next the
nextwhat|next what
ney|they
ne|the
nfarly|nearly
nfeanwhile|meanwhile
nfilitary|military
nfinutes|minutes
nfiss|miss
nght|right
ngw|now
nhss|miss
niace|place
niade|made
niagazine|magazine
niahogany|mahogany
niain|main
niaking|making
niany|many
niaraud|maraud
niaterials|materials
niay|may
nicans|means
nicelooking|nice looking
nicht|night
nicolethere|nicole there
nidnaged|managed
nieal|meal
niechanically|mechanically
nieniber|member
nierctiry|mercury
nieter|meter
nie|me
niform|uniform
nigbt|night
nighta|night a
nightbom|nightborn
nightjust|night just
nightreleased|night released
nightthat|night that
nightyou|night you
niidafternoon|midafternoon
niiles|miles
niimber|number
niinded|minded
niiser|miser
nilmher|number
nilnutes|minutes
nilsty|misty
nind|mind
ninedigit|nine digit
ninet|nineth
ninning|running
nin|run
niold|mold
niomelit|minute
nioored|moored
niore|more
niost|most
niountain|mountain
niove|move
nised|promised
nister|mister
nis|his
niuch|much
niurder|murder
niuscular|muscular
niy|my
nled|killed
nlere|there
nlinute|minute
nly|my
nmning|running
nnere|where
nnging|wringing
nng|ring
noblebut|noble but
nobodv|nobody
noctumal|nocturnal
nodiing|nothing
nodongs|missiles
nofair|no fair
noffiwg|nothing
nofth|north
noglared|no glared
noisebut|noise but
nol5e|noise
noments|moments
nomirial|nominal
nonchalandy|nonchalantly
nones|hormones
nonsenselife|nonsense life
noparking|no parking
noplease|no please
noreally|no really
norinally|normally
norm4l|normal
normafly|normally
normak|normal
normegotiable|nonnegotiable
norrh|north
northemer|northerner
northem|northern
nosc|nose
nosedive|nose dive
nosedown|nose down
notationsmaking|notations making
notbing|nothing
notetaking|note taking
notfail|not fail
notfighters|not fighters
notfly|not fly
notgive|not give
nothat|no that
nothingexpressed|nothing expressed
nothingfor|nothing for
nothirig|nothing
nothmg|nothing
notificationand|notification and
noti|not i
notjust|not just
notlung|nothing
notmng|nothing
notorioussomeone|notorious someone
notorisly|notoriously
notso|not so
notwish|not wish
nough|enough
novcmhcr|november
novemher|november
nowadmittedly|now admittedly
nowespecially|now especially
nowfamiliar|now familiar
nowledge|knowledge
nown|known
nowthinking|now thinking
nowwhat|now what
nqw|now
nrecisely|precisely
nry|my
nse|rise
nsiderably|considerably
nssion|mission
nstallations|installations
nsufficient|insufficient
nterprise|enterprize
nterrupted|interrupted
ntire|entire
ntm|him
ntr6e|entrees
ntunber|number
nty|my
nudgenudge|nudge nudge
nufses|nurses
nught|might
nuiiierous|numerous
nukeg|nukes
nules|miles
numberwhy|number why
numhered|numbered
numher|number
nund|mind
nune|mine
nuniber|number
nursc|nurse
nursewhich|nurse which
nursmg|nursing
nussing|missing
nussissippi|mississippi
nustress|mistress
nver|never
nvhat|what
nvithout|without
nwd|mad
nwke|make
nwne|name
nwrnin|morning
nwved|moved
nything|nothing
nzake|make
nzan|man
oam|own
oathabout|oath about
obably|probably
objectsthe|objects the
objec|object
observationsand|observations and
obsessivecompulsive|obsessive compulsive
obsffved|observed
ob|oh
occasionafly|occasionally
occasionay|occasionally
occuffed|occurred
ockpit|cockpit
octoberand|october and
octoberthey|october they
octobier|october
octoher|october
octor|doctor
odhers|others
odi6r|other
ofall|of all
ofand|of and
ofantibiotics|of antibiotics
ofaverage|of average
ofa|of a
ofbantarn|of bantam
ofbeing|of being
ofblueprint|of blueprint
ofbreathing|of breathing
ofcandlelight|of candlelight
ofcer|officer
ofcharring|of charring
ofcleansing|of cleansing
ofcomplications|of complications
ofconsciousness|of consciousness
ofcourse|of course
ofdate|of date
ofdreaming|of dreaming
ofeagles|of eagles
ofemotions|of emotions
ofemotion|of emotion
ofessional|professional
ofeternity|of eternity
ofeverything|of everything
ofevery|of every
offabout|off about
offacer|officer
offact|of fact
offand|off and
offa|off a
offbalance|off balance
offce|officer
offduty|off duty
offeet|of feet
offefing|offering
offficer|officer
offfice|office
offficial|official
offguard|off guard
offhandedly|off handedly
offher|off her
offhis|off his
officerslieutenants|officers lieutenants
officiallooking|official looking
offigures|of figures
offin|off in
offjauntily|off jauntily
offlcers|officers
offlcer|officer
offload|off load
offlowers|of flowers
offme|office
offone|off one
offooocers|officers
offpattern|off pattern
offriction|of friction
offscreen|off screen
offshort|off short
offshot|off shot
offspringmen|offspring men
offthat|off that
offthe|off the
offthings|off things
offthree|off three
offto|off to
offwhenever|off whenever
offwithout|off without
offwith|off with
offworiders|off worlders
ofget|of get
ofglances|of glances
ofher|of her
ofhim|of him
ofhisfellow|of his fellow
ofhis|of his
oficer|officer
ofits|of its
ofit|of it
ofjack|of jack
ofjeans|of jeans
ofjudges|of judges
ofjustice|of justice
ofkin|of kin
ofknowing|of knowing
oflicers|officers
oflicer|officer
oflier|other
oflightning|of lightning
oflittle|of little
ofl|off
ofmaterial|of material
ofmedicine|of medicine
ofme|of me
ofmiscellaneous|of miscellaneous
ofmonotony|of monotony
ofmyself|of myself
ofmy|of my
ofnumbers|of numbers
ofor|of or
ofour|of our
ofpain|of pain
ofpeople|of people
ofplace|of place
ofpleasure|of pleasure
ofpneumonia|of pneumonia
ofpoems|of poems
ofpreparation|of preparation
ofpressure|of pressure
ofproving|of proving
ofp|off
ofren|often
ofricers|officers
ofricer|officer
ofrice|office
ofrogue|of rogue
ofrules|of rules
ofrunning|of running
ofsatisfaction|of satisfaction
ofsaying|of saying
ofsemester|of semester
ofshock|of shock
ofsight|of sight
ofsilence|of silence
ofsmoke|of smoke
ofsomething|of something
ofspecial|of special
ofspelling|of spelling
ofteii|often
ofterror|of terror
oftheambush|of the ambush
oftheir|of their
ofthem|of them
ofthe|of the
ofus|of us
ofuterra|of uterra
ofvegetation|of vegetation
ofwaiting|of waiting
ofwater|of water
ofweakness|of weakness
ofweariness|of weariness
ofwet|of wet
ofwhat|of what
ofwhich|of which
ofwill|of will
ofwon|of won
ofworking|of working
ofyears|of years
ofyourself|of yourself
ofyours|of yours
ofyour|of your
ofyou|of you
ofzenna|of zenna
ohfor|oh for
ohjects|objects
ohly|only
ohmy|oh my
ohto|onto
ohyou|oh you
oiice|once
oiie|one
oiiiv|only
oiilv|only
oiily|only
oiir|our
oiitside|outside
oiit|out
oii|on
ojfice|office
oji|on
okayjust|okay just
oklahomanebraska|oklahoma nebraska
oldcountry|old country
olderstyle|older style
olitlets|outlets
olito|onto
olit|out
oli|oh
oli|on
ollowed|followed
olten|often
ol|of
omamental|ornamental
omately|ornately
omclctte|omelette
oment|moment
omery|ornery
omment|comment
ompletely|completely
om|old
onagain|on again
oncc|once
onceand|once and
oncefamiliar|once familiar
onceso|once so
onc|one
ondelivery|on delivery
oneand|one and
oneat|one at
onea|one a
onebut|one but
onecollected|one collected
oneperson|one person
onesclosed|ones closed
onestory|one story
onethat|one that
oniv|only
oniy|only
onjanuary|on january
onlj|only
onlv|only
onlythe|only the
onlywithin|only within
onsibility|responsibility
onstage|on stage
ontents|contents
onthe|on the
onthough|on though
onwon|someone
oocooning|cocooning
oodl|lord
ooking|looking
oomer|corner
opcncd|opened
opcration|operation
opeid|open
opeii|open
opemng|opening
openand|open and
operafion|operation
ophthahnologist|ophthalmologist
ople|people
orderlv|orderly
orderno|order no
ordinarylooking|ordinary looking
orever|or ever
orfire|or fire
organizationwhich|organization which
orjournalist|or journalist
orjust|or just
orted|reported
otber|other
otfering|offering
otficers|officers
otfice|office
othcr|other
othdr|other
othees|others
othercar|other car
otherzvise|otherwise
othffsr|officer
otie|one
otir|our
otit|out
otner|other
ouestions|questions
oufflowing|outflowing
ough|enough
ouided|guided
oul|out
oun|own
ourjob|our job
ournalists|journalists
ourprotection|our protection
outand|out and
outbecause|out because
outexcept|out except
outfor|out for
outgide|outside
outhoard|outboard
outlooking|out looking
outnumhered|outnumbered
outof|out of
outsidethe|outside the
outthat|out that
outthirty|out thirty
outwhere|out where
outwith|out with
ouz|out
ovcr|over
ove6oyed|overjoyed
ovedoyed|overjoyed
ovei|over
ovemighter|over nighter
ovemight|overnight
overalldark|overall dark
overand|over and
overthe|over the
overwhellned|overwhelmed
ovm|own
ovn|own
owii|own
ownhis|own his
ownweapon|own weapon
owt|owl
oxerdo|over do
oxygenpanel|oxygen panel
packedthe|packed the
padis|paths
padthe|pad the
paftem|pattern
pahdner|partner
pahn|palm
paimar|palmar
painfidly|painfully
painicss|painless
pairit|paint
pamphlct|pamphlet
panicstricken|panic stricken
pantiesfrom|panties from
pantswhich|pants which
paperso|paper so
paraflel|parallel
paraiumpers|paratroopers
paraphernaliafilled|paraphernalia filled
parentsparticularly|parents particularly
parficular|particular
parfly|partly
parkerjumped|parker jumped
parldng|parking
particiation|participation
particiilar|particular
partitionthe|partition the
partrecognized|part recognized
partsfingers|parts fingers
pasnate|passionate
pass6|passe
passagewa|passageway
passeduntil|passed until
passiqn|passion
pastdark|past dark
patemalism|paternalism
patheticafly|pathetically
patiendy|patiently
patni|palm
patrollipg|patrolling
patrolssquad|patrols squad
pattemed|patterned
pattems|patterns
pattem|pattern
pauets|pallets
pav|pay
paymentselectric|payments electric
pcrfcct|perfect
pcrt|port
peacefiluy|peacefully
pecially|especially
pecple|people
pedestrianof|pedestrian of
peepbut|peep but
pefictly|perfectly
pemarkably|remarkably
pemicious|pernicious
pemiission|permission
pencfl|pencil
penctrator|penetrator
pendingand|pending and
penetfated|penetrated
penicillinresistant|penicillin resistant
penitentiapy|penitentiary
penmeters|perimeters
pentagonwhere|pentagon where
penuission|permission
peofle|people
peopie|people
peoplc|people
peopleand|people and
peopleespecially|people especially
peopleeveryone|people everyone
peoplehell|people hell
peopleinnocent|people innocent
peopleon|people on
peopleproduct|people product
peoplethey|people they
peoplewhich|people which
perbaps|perhaps
perfecfiy|perfectly
perfeet|perfect
perffectly|perfectly
perforrn|perform
perhapsand|perhaps and
permanentlyy|permanently
perons|persons
perpaps|perhaps
persianhad|persian had
persoiial|personal
persoii|person
personafly|personally
personinstead|person instead
petcr|peter
petroleumjehy|petroleum jelly
pfayed|prayed
pfedicament|predicament
pficked|pricked
pfince|prince
pfisoner|prisoner
pfize|prize
pfllar|pillar
pfocessing|processing
phantorn|phantom
phasedrastically|phase drastically
phgrimage|pilgrimage
phikidelphia|philadelphia
philosophicauy|philosophically
phonc|phone
photogaph|photograph
photosalmost|photos almost
photosthe|photos the
phvsical|physical
physicalform|physical form
physicaliv|physically
piay|play
picardstood|picard stood
picccs|pieces
picldng|picking
pictiire|picture
pictlire|picture
picturesno|pictures no
picturewell|picture well
pidducts|products
piecesmade|pieces made
pifl|pill
piiblic|public
piisoner|prisoner
piit|put
pilgfims|pilgrims
pilgrimsand|pilgrims and
pillowbut|pillow but
pim|plain
pinepaneled|pine paneled
pinkform|pink form
pinpoiit|pinpoint
pinsomething|pin something
piolets|pilots
pirmed|pinned
pirnply|pimply
pissalot|piss alot
pitcb|pitch
placc|place
placelooked|place looked
placepeople|place people
plaii|plan
plam|plain
planct|planet
planningprognamming|planning programming
plantsnot|plants not
plasftr|plaster
plasticencased|plastic encased
platforirn|platform
playfttl|playful
pleasedid|please did
pliances|appliances
plotgetting|plot getting
plsiol|pistol
plununet|plummet
pluswhich|plus which
pnvately|privately
pnvate|private
pobt|poet
pohce|police
poiiit|point
pointhaving|point having
pointsin|points in
poldce|police
policeand|police and
policecar|police car
policedepartment|police department
policeexam|police exam
policeshould|police should
pomographic|pornographic
pom|porn
poolgoing|pool going
poorlv|poorly
poorquality|poor quality
popcom|popcorn
porcb|porch
positioii|position
positivcly|positively
positiveif|positive if
posrible|possible
possbility|possibility
possibilitythe|possibility the
possiblebecause|possible because
possiblethat|possible that
possiblethough|possible though
posssession|possession
postems|posterns
postholes|post holes
postmission|post mission
posttarget|post target
postyou|post you
pothellied|potbellied
pouads|pounds
poundmg|pounding
powcr|power
powerand|power and
powerbecame|power became
powerfal|powerful
powerprompted|power prompted
ppage|page
pqople|people
pr6ssure|pressure
pracdtioner|practitioner
practicafly|practically
prceedent|precedent
prcsence|presence
preacherthat|preacher that
preaeher|preacher
predictorvalidity|predictability
prefeffed|preferred
preffighting|preflighting
pregnancyimplanted|pregnancy implanted
pregrain|program
preigious|prestigious
prepaning|preparing
preparedfor|prepared for
prescient|present
preseiit|present
presideiit|president
pressiire|pressure
pressurebreathing|pressure breathing
pressuresthough|pressures though
pretry|pretty
preyhuman|prey human
priestcame|priest came
priestseach|priests each
principleof|principle of
printfd|printed
printswhich|prints which
probkm|problem
problemsolving|problem solving
proceeddings|proceedings
processto|process to
proclaimedand|proclaimed and
proclaimedtheir|proclaimed their
productswhich|products which
professionalwriters|professional writers
professorjohn|professor john
projecffle|projectile
prominentjournalist|prominent journalist
promiseyou|promise you
pronused|promised
propellerdriven|propeller driven
prosecuter|prosecutor
prot6g6s|professionals
protecfing|protecting
protocolsformalities|protocols formalities
provc|prove
psychodiagnostic|psycho diagnostic
ptiest|priest
ptisoner|prisoner
pubfic|public
pubiic|public
publocations|publications
puffnag|puffing
pufj|puff
pufled|pulled
pufl|pull
puiled|pulled
pulf|pull
puling|pulling
pullcd|pulled
punetufing|puncturing
punisbment|punishment
purplestriped|purple striped
pushmg|pushing
puttingthem|putting them
puuing|pulling
puumg|pulling
puu|pull
pyrantid|pyramid
qestion|question
qf|of
qiiestion|question
qiiite|quite
qnd|and
qtiiclde|quickie
qtuetly|quietly
quaffels|quarrels
quarantinc|quarantine
quartersrent|quarters rent
queioned|questioned
quesffons|questions
questioii|question
questionmg|questioning
quicidy|quickly
quifl|quill
quitc|quite
quizzicahy|quizzically
qvdet|quiet
qwckly|quickly
qwetly|queerly
qwet|quiet
qwte|quite
r6sum6s|resumes
raay|may
rabics|rabies
racebut|race but
raciallyincapable|racially incapable
racketball|racquetball
radarguided|radar guided
radarjamming|radar jamming
radiofrequency|radio frequency
radionot|radio not
radiopolice|radio police
raffroad|railroad
rafn|rain
rafrs|rafts
ragedjust|raged just
raih|rail
raiige|range
rainbowcolored|rainbow colored
rainstonns|rainstorms
rainstonn|rainstorm
rainwith|rain with
rakedfour|raked four
ranchstyle|ranch style
rangebut|range but
rangedemanding|range demanding
rangemaster|range master
rankmg|ranking
rankordered|rank ordered
rankorder|rank order
ranksmelling|rank smelling
ranldng|ranking
ransportation|transportation
ransportati|transportation
rarnrods|ramrods
ratc|rate
ratherportly|rather portly
rattie|rattle
rauroad|railroad
rbat|that
rbetorical|rhetorical
rbythm|rhythm
rcach|reach
rcally|really
rcd|red
rciunded|rounded
rcplied|replied
rcst|rest
rdered|ordered
reachlng|reaching
reacr|react
reactionarymake|reactionary make
reafly|really
reahn|realm
reakfast|breakfast
realizedthat|realized that
reallv|really
reallybut|really but
reallynothing|really nothing
reall|really
reappearence|reappearance
rearguard|rear guard
reasoii|reason
reasonabic|reasonable
reasonand|reason and
reasongood|reason good
reasonsthey|reasons they
reatize|realize
reaued|realized
rebabijtate|rehabilitate
rebelhon|rebellion
rebeved|relieved
rebom|reborn
rebufld|rebuild
recafl|recall
reccfrd|record
receiit|recent
recieyed|recieved
reckonmg|reckoning
recmw|record
recofled|recoiled
recogize|recognize
recordswhich|records which
recoveredor|recovered or
recriniinations|recriminations
recruitingposter|recruiting poster
recruitthey|recruit they
reddishgold|reddish gold
redeploymentorder|redeployment order
redstandby|red standby
reefly|really
reember|remember
reement|agreement
refeffed|referred
referencesjust|references just
refiective|reflective
refleshing|refreshing
reflw|reflected
reforined|reformed
refpond|respond
refrigeratorwhich|refrigerator which
reftige|refuge
refumed|returned
registrada|registration
regretfid|regretful
regretfiilly|regretfully
regulationsand|regulations and
rehef|relief
rehis|reins
rehoistered|reholstered
reinamed|remained
reinind|remind
relationshipwith|relationship with
releam|relearn
releasedbefore|released before
releasewhatever|release whatever
relicbut|relic but
relicsand|relics and
relieyed|relieved
religioiis|religious
religionsand|religions and
reluctlitit|reluctant
remarkedand|remarked and
rematkable|remarkable
remcmbered|remembered
rememberand|remember and
rememberbut|remember but
remembere|remembered
rememer|remember
rememhered|remembered
rememher|remember
remilitafization|remilitarization
remmbering|remembering
remotecontrolled|remote controlled
renglon|religion
reniaiii|remain
renunded|reminded
repcated|repeated
repined|regained
repo7ter|reporter
repomd|returned
reportand|report and
reportswell|reports well
reporttng|reporting
reproductivewhat|reproductive what
repticator|replicator
repubhc|republic
reqiiired|required
requirementwe|requirement we
rerilember|remember
rerognize|recognize
rescuecoordinating|rescue coordinating
resembte|resemble
resiilt|result
respectfitily|respectfully
responibility|responsibility
responsibilityswitching|responsibility switching
responsiblebut|responsible but
restforever|rest forever
restlcss|restless
restrictionssome|restrictions some
resultsso|results so
resurfaceif|resurface if
retatives|relatives
retiirn|return
retty|pretty
retuge|refuge
retumed|returned
retuming|returning
retums|returns
retum|return
returii|return
returnto|return to
revcue|rescue
revefie|reverie
revious|previous
revolutionbritish|revolution british
rewar|reward
rewed|revved
rewing|revving
rewnte|rewrote
rext|rest
reznembered|remembered
rght|right
rgotten|forgotten
rgument|argument
rhe|the
rhythinically|rhythmically
ridethe|ride the
ridmg|riding
riends|friends
rifty|fifty
rightand|right and
rightas|right as
rightbut|right but
righteveryone|right everyone
rightfzd|rightful
righthand|right hand
rihs|ribs
riieant|meant
riin|run
riiy|my
rimaced|grimaced
ringingfinally|ringing finally
ringingto|ringing to
rininutes|minutes
ripbut|rip but
rirms|firms
rirn|rim
riskiermthrowing|riskier throwing
riskyto|risky to
riuch|much
rived|arrived
riverjust|river just
riyht|right
rked|worked
rlm|run
rmau|small
rmed|remembered
rmght|might
rmnuscnpt|manuscript
rmnute|minute
rmsed|raised
rnace|furnace
rnaking|making
rnale|male
rncans|means
rnilky|milky
rnind|mind
rnisty|misty
rnom|mom
rnood|mood
rnoved|moved
rny|my
roadthe|road the
robably|probably
rocketpropelled|rocket propelled
rocketstwo|rockets two
rockingharn|rockingham
rockingha|rockingham
rocldes|rockies
rocle|rock
rodcy|rocky
roffee|coffee
rofled|rolled
rofl|roll
roject|project
roke|broke
rolexfour|rolex four
rollg|rolling
romancandles|roman candles
romts|hours
rom|from
roofand|roof and
rooni|room
roorm|room
roorn|room
rorget|forget
roundeyes|round eyes
routeanother|route another
rou|roll
rowhoats|rowboats
rowniiig|frowning
royserf|myself
rqof|roof
rqy|my
rrfind|mind
rrv|my
rtiarch|march
rubbemeck|rubberneck
rubher|rubber
rucksackand|rucksack and
rughts|nights
ruii|run
rulc|rule
rulesand|rules and
runnmg|running
runsfrom|runs from
runwas|run was
ruount|mount
rusfler|rustler
russel|russell
rwnner|manner
rwnute|minute
rwo|two
ryansseemed|ryan seemed
ryiattered|mattered
s4eep|sleep
s4he|she
s4ie|she
s6ances|seances
s6lling|selling
s6me|some
sacfifice|sacrifice
saddied|saddled
saf6ty|safety
safd|said
saflor|sailor
safl|sail
sahy|sally
saicl|said
saict|said
saidand|said and
saidwhen|said when
sailfor|sail for
sailingdrowned|sailing drowned
sainf|saint
saintssince|saints since
sairl|said
saity|salty
sajd|said
sak6|sake
sald|said
samc|same
samjerked|sam jerked
sampies|samples
samplc|sample
sanie|same
sanityagainst|sanity against
saphng|sapling
sari|said
sattirday|saturday
savedtransferred|saved transferred
savs|says
sawdustwhich|sawdust which
sayand|say and
sayit|say it
saypolitely|say politely
saysthat|says that
saythis|say this
sbackle|shackle
sbade|shade
sbafl|shall
sbakes|shakes
sballows|shallows
sbaped|shaped
sbare|share
sbe|she
sbirt|shirt
sbit|shit
sbjected|subjected
sboe|shoe
sboot|shoot
sbould|should
scabhard|scabbard
scannin|scanning
scarfoff|scarf off
scas|seas
scatbacks|seatbacks
scatback|seatback
scatmred|scattered
scattermg|scattering
sca|sea
scclirltv|security
sccm|seem
scc|see
scemed|seemed
scen|seen
sce|see
schoolteaching|school teaching
schoolthis|school this
scienceand|science and
scmething|something
scomed|scorned
scom|scorn
scptemher|september
scrcen|screen
screamedjoyftilly|screamed joyfully
scroungedup|scrounged up
scrvice|service
sct|set
scx|sex
sdd|said
sdfe|safe
sdid|said
seaguils|seagulls
seani|seam
searchand|search and
searchingfor|searching for
searchingthe|searching the
seared|scared
seatback|seat back
seathelts|seatbelts
secoiid|second
seconddegree|second degree
secondgrade|second grade
secondto|second to
secqnd|second
sectioii|section
securityconscious|security conscious
securtty|security
seeanything|see anything
seeii|seen
seeldng|seeking
seemedfoolproof|seemed foolproof
seenano|scenario
seenbut|seen but
seenis|seems
sefid|said
sefior|senor
sefling|selling
sefl|sell
sei2ing|seizing
seiise|sense
seldoni|seldom
selfiiiiportant|selfimportant
sences|senses
seniorgrade|semi or grade
senous|serious
sensationtouching|sensation touching
sensibleexcept|sensible except
septembcr|september
septemberbut|september but
septemher|september
sergeantregular|sergeant regular
seridce|service
seriotisness|seriousness
seriouslyabout|seriously about
serniauto|semiauto
serpentthe|serpent the
seryants|servants
sessionspecifically|session specifically
setpent|serpent
settied|settled
settingup|setting up
setvices|services
setvice|service
seuffed|scuffed
seuled|settled
sevcn|seven
seveial|several
sevenfoot|seven foot
seventeenyear|seventeen year
seventypoint|seventy point
severaltimes|several times
severelyfrowned|severely frowned
sffly|silly
sffved|served
sfiffened|stiffened
sfiifte|shifted
sfill|still
sfin|slim
sflently|silently
sflk|silk
sftmger|stranger
sh6uld|should
shadowhof|shadow of
shafl|shall
shakinc|shaking
shaldng|shaking
shan|shall
sharne|shame
shat|shit
shau|shall
shcker|slicker
shc|she
shding|sliding
sheand|she and
sheddmg|shedding
sheetsand|sheets and
sheheld|she held
shekered|slickered
shewasdefeated|she was defeated
shewas|she was
shifr|shift
shifung|shifting
shiloh|shilo
shinnnering|shimmering
shirtseeing|shirt seeing
shitoutta|shit outta
shiveiung|shivering
shivenng|shivering
shmne|shame
shm|slim
shnigged|shrugged
shoehomed|shoehorned
shoeshine|shoe shine
shoiild|should
shom|shorn
shotgtm|shotgun
shotsthe|shots the
shouldjust|should just
showerand|shower and
showii|shown
showwhich|show which
shunmer|shimmer
shuttlethe|shuttle the
si7ver|silver
siccplng|sleeping
siddown|sit down
sideldck|sidekick
sideof|side of
sieffa|sierra
sie|she
siffing|sifting
sifungs|siftings
sigbt|sight
sighdessly|sightlessly
siglit|sight
signai|signal
sigri|sign
sih|sill
siibject|subject
siich|such
siience|silence
siiice|since
siiigle|single
siiit|shit
siinply|simply
siipport|support
siire|sure
siirface|surface
silelitly|silently
silentiv|silently
silre|sure
silverhaired|silver haired
silvertips|silver tips
simpie|simple
simpsonwalk|simpson walk
simultaeously|simultaneously
sinart|smart
sincc|since
sincemost|since most
sinceyou|since you
sinell|smell
singedflesh|singed flesh
siniiiarly|similarly
siniplv|simply
sinisterand|sinister and
sinvly|simply
sistcr|sister
sisterall|sister all
sisterand|sister and
sisterbecause|sister because
sisterfor|sister for
sistershe|sister she
sisterstab|sister stab
sisterwere|sister were
sitiiation|situation
sittingjust|sitting just
sittingroom|sitting room
situatioii|situation
situationbut|situation but
siu|sill
sixand|six and
sixfoot|six foot
sixid|said
sjicing|slicing
ske|she
skfll|skill
skht|skirt
skidny|skinny
skiffdown|skiff down
skifled|skilled
skifls|skills
skifl|skill
skinnylegged|skinny legged
skinwe|skin we
skipperthe|skipper the
skiwies|skivvies
skv|sky
skybome|skyborne
slainmed|slammed
slamined|slammed
slammcr|slammer
slamniing|slamming
slanuned|slammed
slccplg|sleeping
slccp|sleep
sldff|skiff
sldnned|skinned
sleeklooking|sleek looking
sleepinstead|sleep instead
sleeptimes|sleep times
slenderfigure|slender figure
sli1|slip
slightiv|slightly
slily|silly
slioulder|shoulder
slipsomething|slip something
slirely|surely
slirn|slim
slnall|small
slopy|sloppy
slowillg|slowing
slowly|slowly
slumher|slumber
slx|six
smafler|smaller
smafl|small
smaii|small
smail|small
smalf|small
smallholding|small holding
smallunit|small unit
smam|small
smar|smart
smau|small
smclled|smelled
smdhing|something
smd|stood
smefl|smell
smelg|smelling
smened|smelled
smeone|someone
smeuing|smelling
smffe|smile
smfled|smiled
smgke|smoke
smihng|smiling
smiied|smiled
smilc|smile
smilirig|smiling
smirldng|smirking
smmng|smiling
smnething|something
smokegrenade|smoke grenade
smoothenough|smooth enough
smushed|smashed
sn3ile|smile
snanng|snagging
snappcd|snapped
snappedit|snapped it
snappitig|snapping
sneakand|sneak and
sne|she
sniart|smart
sniffmg|sniffing
sniiied|smiled
snile|smile
snle|smile
snowfor|snow for
snowhank|snowbank
snpreme|supreme
sntelligence|intelligence
snuffied|snuffled
snule|smile
snwl|smell
so6n|soon
soapmg|soaping
socalled|so called
societybankers|society bankers
sofffy|sorry
soffly|softly
sofled|soiled
softhall|softball
sohd|solid
sohered|sobered
sohne|some
soidiers|soldiers
soiind|sound
soiith|south
soine|some
soity|sorry
soiyiething|something
soiyie|some
sojoumer|sojourner
soldicr|soldier
soldiera|soldier a
soldiets|soldiers
solerrmity|solemnity
solider|soldier
solitarywhich|solitary which
soljnd|sound
sollic|some
solne|some
sombemess|somberness
somcong|someone
somcthing|something
somcwhere|somewhere
somc|some
someabsorbing|some absorbing
someand|some and
somebodyeven|somebody even
somebodywell|somebody well
somebow|somehow
somedhing|something
someffng|something
somefimes|sometimes
somefmes|sometimes
somehowand|somehow and
somemaybe|some maybe
someoneprobably|someone probably
sometbing|something
somethbirlg|something
somethiiig|something
somethinc|something
somethinga|something a
somethingor|something or
somethingsimpler|something simpler
somethingto|something to
sometimesthey|sometimes they
somettilng|something
somnoleiit|somnolent
sonbut|son but
songhirds|songbirds
sonicone|someone
sonictimes|sometimes
soniething|something
sontething|something
sonwone|someone
sooii|soon
sophisticatedfor|sophisticated for
sophlstry|sophistry
sorcerv|sorcery
soreery|sorcery
sorfy|sorry
sormething|something
sorme|some
sornebody|somebody
sornething|sormething
sornewhlere|somewhere
sorrythat|sorry that
sorty|sorry
sothat|saw that
sotiiid|sound
soudi|south
souffl6|souffle
souiid|sound
soumess|sourness
soundfrighteningly|sound frighteningly
soundjust|sound just
sourcebook|source book
sourcesreferences|sources references
souriv|sourly
southemers|southerners
southemer|southerner
southemmost|southernmost
southem|southern
southold|south old
sovietsupplied|soviet supplied
spacc|space
spanishand|spanish and
sparlded|sparkled
sparldmg|sparkling
speakingsomewhere|speaking somewhere
spealdng|speaking
speciesdogs|species dogs
specificafly|specifically
specificallythe|specifically the
specificinstructions|specific instructions
specificwas|specific was
specwaffior|specwarfare
spefling|spelling
spffling|spilling
spflled|spilled
sphsre|sphere
spifit|spirit
spifl|spill
spiii|spill
splecn|spleen
splitsecond|split second
spme|spine
spmng|sprang
spnng|spring
spofls|spoils
spokefirst|spoke first
spokesome|spoke some
spoolder|spookier
sportscar|sports car
sprayedharmlessly|sprayed harmlessly
springhoard|springboard
spum|spurn
spyingm|spying
sqe|see
sqleal|squeal
squcczed|squeezed
srdiled|smiled
srffile|smile
srnfling|smiling
srorms|storms
srtioke|smoke
srvive|survive
ssomethingwrongwith|ssomething wrong with
stabifized|stabilized
stackfrom|stack from
staffcould|staff could
stafffor|staff for
staffion|stallion
staffwas|staff was
stagewhispered|stage whispered
stahion|stallion
staicment|statement
stainedglass|stained glass
stalkedjaway|stalked away
stallioil|stallion
stammer|slammer
standdown|stand down
stanng|staring
stapes|stripes
staplesrice|staples rice
starflect|starfleet
startedyou|started you
startengine|start engine
startetl|started
startied|startled
statemerit|statement
statescreate|states create
statesincluding|states including
statespecifically|state specifically
stationhe|station he
stauion|stallion
stav|stay
stdi|still
stdpped|stopped
steat|steal
steeishod|steelshod
stemer|sterner
stenuned|stemmed
steppedonto|stepped onto
stepsthe|steps the
stevensthen|stevens then
stffl|still
stfiding|striding
stfife|strife
stfike|strike
stfll|still
stfuke|strike
sthl|still
stiarl|snarl
sticldng|sticking
stie|she
stiffiiess|stiffless
stiflened|stiffened
stifl|still
stih|still
stiidents|students
stiidy|study
stiiii|still
stili|still
stilland|still and
stillbom|stillborn
stillyou|still you
stin|still
stispect|suspect
stitfening|stiffening
stiunbled|stumbled
stiu|still
stlfl|still
stlibborn|stillborn
stlidying|studying
stlll|still
stlu|still
stmke|strike
stniggle|struggle
stniling|smiling
stnith|smith
stnted|started
stomi|storm
stoopshouldered|stoop shouldered
storedfrozen|stored frozen
storined|stormed
storin|storm
storyabout|story about
storyand|story and
storyfrom|story from
storyn|storm
stoties|stories
stoutlv|stoutly
strangelove|strange love
strangerthat|stranger that
strategicbombing|strategic bombing
strcct|street
streakson|streaks on
streetiarnps|streetlamps
streetjournal|street journal
streetlatnps|streetlamps
stresstorturepeople|stress torture people
strinfs|strings
stroiiglv|strongly
stroiig|strong
structions|instructions
stubbomly|stubbornly
stubbom|stubborn
studeiits|students
studentsunion|students union
stuffit|stuff it
stuffpig|stuff pig
stuffthat|stuff that
stufftwenty|stuff twenty
stuffwas|stuff was
stul|still
stunmoned|summoned
sturdybuilt|sturdy built
stutf|stuff
stvles|styles
subantial|substantial
subcomrriittees|subcommittees
subitute|substitute
subjectas|subject as
subpattems|subpatterns
substantiafly|substantially
sucb|such
successftil|successful
successfufly|successfully
suddcnly|suddenly
sudderdy|suddenly
suffendered|surrendered
suffender|surrender
suflered|suffered
suggeed|suggested
suggestedproved|suggested proved
suittrousers|suit trousers
sumiised|surmised
summerand|summer and
sunbleached|sun bleached
sunblindness|sun blindness
sunday|sunday
sundjly|sunday
sunimatioiis|summations
sunmaybe|sun maybe
sunnise|surmise
sunshowed|sun showed
sununarized|summarized
supeiior|superior
supematural|supernatural
superlawyer|super lawyer
superors|superiors
supervisorwell|supervisor well
supposely|supposedly
supposeyou|suppose you
supvosed|supposed
surc|sure
surebut|sure but
surelv|surely
suremaybe|sure maybe
surfacefeeding|surface feeding
surfaceto|surface to
surfathee|surface
surpfised|surprised
surpise|surprise
surrcnder|surrender
surrised|surprised
surveillancein|surveillance in
svmpathetic|sympathetic
svstcm|system
swagget|swagger
swain|swam
swanmng|swarming
swcat|sweat
swcide|suicide
sweetsmelling|sweet smelling
swefl|swell
swepr|swept
swiffly|swiftly
swiftcurrent|swift current
swilluning|swimming
swimniing|swimming
swingout|swing out
swinn|swim
switcl4|switch
swne|same
swom|sworn
swordwielding|sword wielding
synoldered|smoldered
systemwide|system wide
t0|to
t14e|the
t1heir|their
t1hough|though
t4eir|their
t4e|the
tabletwo|table two
tacitum|taciturn
tacticalfighter|tactical fighter
tae|taste
taff|tall
taflhook|tailhook
tafl|tall
tah|tall
taidng|taking
taildng|talking
tailplane|tail plane
takc|take
takeaway|take away
takeii|taken
takenbecause|taken because
takenfour|taken four
takiiig|taking
taki|taking
taldng|taking
talidng|talking
tali|tall
talkactually|talk actually
talkiqq|talking
talkwhat|talk what
talldng|talking
tamation|tarnation
tamished|tarnished
tanding|standing
tannac|tarmac
tapc|tape
tapestrycovered|tapestry covered
targetjust|target just
tartnac|tarmac
tasteftdly|tastefully
tather|father
tatter|taller
taudng|talking
tau|tall
tavemkeepers|tavernkeepers
tavem|tavern
tawing|talking
taxipath|taxi path
tbank|thank
tban|than
tbat|that
tbcre|there
tbc|the
tbeir|their
tben|then
tbere|there
tbese|these
tbey|they
tbe|the
tbings|things
tbing|thing
tbink|think
tbirty|thirty
tbis|this
tbit|that
tbld|told
tbougbt|thought
tbree|three
tbrift|thrift
tbrill|thrill
tbroat|throat
tbrough|through
tbund|found
tbursday|thursday
tb|the
tcam|team
tclephone|telephone
tcll|tell
tcn|ten
tc|to
tdck|trick
tdngue|tongue
teachmg|teaching
teajn|team
teakpaneled|teak paneled
teaming|learning
teamwhich|team which
teanis|teams
teasedjust|teased just
teatn|team
teaving|leaving
teazn|team
technicallyhe|technically he
teclinically|technically
teclinical|technical
tecnical|technical
tedier|tether
teedl|teeth
teethrattling|teeth rattling
tefling|telling
tefls|tells
tefl|tell
teh|tell
teii|ten
teil|tell
telcphone|telephone
televisionthat|television that
telieved|relieved
telligence|intelligence
tellthem|tell them
tellthe|tell the
telplessly|helplessly
teltwe|telltale
telug|telling
tem|term
tendollar|ten dollar
tenhour|ten hour
tenified|terrified
tenminute|ten minute
terisks|terrorists
terminalwhere|terminal where
ternfied|terrified
terribiy|terribly
territoryquickly|territory quickly
terr|tell
tertified|terrified
testimonynow|testimony now
testimonytwo|testimony two
testingprovided|testing provided
testsfor|tests for
teuing|telling
teu|tell
texthooks|textbooks
tffis|this
tfiat|that
tfice|trice
tfiem|them
tfie|the
tfiis|this
tfim|trim
tfio|trio
tfll|till
tf|if
tgld|told
tg|to
th6re|there
th6|the
thaff|that
thaii|than
thai|that
thal|that
thandemure|than demure
thanwhite|than white
thatabout|that about
thatand|that and
thatanother|that another
thatas|that as
thatbecause|that because
thatbe|that be
thatbut|that but
thatday|that day
thatdead|that dead
thatdisposed|that disposed
thatflowed|that flowed
thatfor|that for
thathe|that he
thatjagged|that jagged
thatlimit|that limit
thatmyth|that myth
thatpoking|that poking
thatright|that right
thatstrong|that strong
thatthat|that that
thatthis|that this
thatwave|that wave
thatwhat|that what
thatyou|that you
thb|the
thcn|then
thcrc|there
thcre|there
thcsc|these
thcv|they
thc|the
thd|the
theamerica|the america
theboston|the boston
thebureau|the bureau
theb|they
theclock|the clock
thecooling|the cooling
thefaces|the faces
thefear|the fear
thefemale|the female
thefilm|the film
thefirst|the first
theflesh|the flesh
theforces|the forces
thefourth|the fourth
thefrst|the first
thefuneral|the funeral
thehill|the hill
thehouse|the house
theii|then
theirfeast|their feast
theirfriends|their friends
theirjob|their job
theirjudgment|their judgment
thejagged|the jagged
thejarhead|the jarhead
thejar|the jar
thejasmine|the jasmine
thejudge|the judge
thelaunch|the launch
thelibrary|the library
thelitary|military
thelr|their
themafter|them after
themain|the main
themare|them are
thembut|them but
theministry|the ministry
themorning|the morning
themseives|themselves
themselvesor|themselves or
themso|them so
thenabout|then about
thencome|then come
thengoingon|then going on
thenhe|then he
thenperfect|then perfect
theoil|the oil
theonly|the only
theorder|the order
thepagefor|the page for
theparty|the party
therc|there
therecord|there cord
therecould|there could
theregive|there give
thereit|there it
thereor|there or
therestayed|there stayed
therethese|there these
thereurging|there urging
therevanished|there vanished
therewas|there was
therewere|there were
thern|them
theroad|the road
theroom|the room
therussian|the russian
thesc|these
theseand|these and
thesecnetary|the secretary
thesecond|the second
theshoulder|the shoulder
thestocky|the stocky
thetest|the test
thetiger|the tiger
thetransfer|the transfer
thetruth|the truth
theul|them
thev|they
thewater|the water
thewhat|the what
thewindow|the window
theyand|they and
theyfeared|they feared
theyhad|they had
theyrealized|they realized
theywere|they were
thf|the
thhat|that
thickerset|thicker set
thickfingered|thick fingered
thickflat|thick flat
thie|the
thiiigs|things
thiiig|thing
thiiik|think
thiimb|thumb
thiis|thus
thingand|thing and
thingclayton|thing clayton
thingdespite|thing despite
thingi|thing i
thingone|thing one
thingswell|things well
thingthis|thing this
thingthrough|thing through
thingwell|thing well
thinh|think
thinkwhat|think what
thinkyou|think you
thirda|third a
thirddegree|third degree
thirdfloor|third floor
thiriking|thinking
thirik|think
thirteenthcentury|thirteenth century
thirteenwho|thirteen who
thirtysomething|thirty something
thisabout|this about
thisall|this all
thisa|this a
thisbecause|this because
thisbut|this but
thisdresses|this dresses
thisfast|this fast
thisfighting|this fighting
thisfor|this for
thisfunny|this funny
thishappy|this happy
thisif|this if
thisis|this is
thisplace|this place
thisthe|this the
thisthis|this this
thistime|this time
thiswith|this with
thisyou|this you
thke|take
thls|this
thmgs|things
thoiight|thought
thoiigh|though
thombushes|thornbushes
thoms|thorns
thornsat|thorns at
thosc|those
thougb|though
thoughtfidly|thoughtfully
thoughtsyou|thoughts you
thoughtthe|thought the
thoughtwhat|thought what
though|though
thoug|through
thousanddollar|thousand dollar
thousandpounder|thousand pounder
thp|the
thqnkfill|thankful
thrcc|three
threc|three
threeand|three and
threeday|three day
threeminute|three minute
threestar|three star
threeweeks|three weeks
thrgugh|through
throiigh|through
throlja|through
througl|through
througt|throughout
thst|that
ththet|that
thtnk|think
tht|the
thunday|thursday
thunderstonns|thunderstorms
thunderstonn|thunderstorm
thunderstopm|thunderstorm
thunderstorin|thunderstorm
thunsday|thursday
thzit|that
tickedoff|ticked off
ticketsfor|tickets for
tier|her
tifing|tiring
tifl|till
tifs|this
tigerjackets|tiger jackets
tihe|the
tihie|time
tiiark|mark
tiiat|that
tiiem|them
tiie|the
tiiiic|time
tiine|time
tiirned|turned
tiirn|turn
tiiumph|triumph
tilat|that
tilings|things
tilking|talking
tilks|talks
tiltimately|ultimately
timcd|timed
timc|time
timeboth|time both
timeelse|time else
timeepisode|time episode
timefor|time for
timen|time
timesas|times as
timesbut|times but
timesfor|times for
timeshape|time shape
timethat|time that
timethink|time think
timewhich|time which
timewith|time with
timnel|tunnel
timt|time
tind|find
tingemails|fingernails
tingemail|fingernail
tinging|ringing
tinic|time
tinies|times
tinished|finished
tinle|time
tinw|times
tirrie|time
tirst|first
titaniumhooked|tit and unhooked
titne|time
titsucking|tit sucking
tittle|little
tiuit|that
tiust|trust
tizne|time
tjiink|think
tjnie|time
tkere|there
tke|the
tlanksgiving|thanksgiving
tlen|then
tlere|there
tle|the
tlfe|the
tlfis|this
tlhat|that
tlhey|they
tliank|thank
tliat|that
tlicir|their
tlieir|their
tlie|the
tlils|this
tliousan|thousand
tlirough|through
tlis|this
tliud|thud
tlle|the
tllne|time
tllree|three
tllrough|through
tllted|tilted
tlme|time
tlns|this
tlus|this
tme|time
tmm|train
tmne|time
tmnking|thinking
tmns|turns
tmportant|important
tms|this
tnade|made
tnat|that
tned|tried
tneir|their
tnere|there
tne|the
tnicks|trucks
tnindling|trundling
tnist|trust
tnmm|then
tnreat|threat
tnterestmg|interesting
toanother|to another
toceiling|to ceiling
tochange|to change
tocs|toes
todate|to date
todaythey|today they
today|today
todk|took
todv|today
toether|together
tofall|to fall
tofast|to fast
tofind|to find
toflee|to flee
tofl|toil
toforce|to force
toforgive|to forgive
toforward|to forward
togedler|together
togetherand|together and
togetherwe|together we
togic|logic
toground|to ground
tohat|that
toheart|to heart
tohouse|to house
tojd|told
tojustifying|to justifying
tojust|to just
tolci|told
toldangel|told angel
toldhim|told him
toldme|told me
tolich|touch
tomacat|tomcat
tomadoes|tornadoes
tombston|tombstone
tomoffow|tomorrow
tomouth|to mouth
tongbow|longbow
tongueand|tongue and
tonibstone|tombstone
tonigh4|tonight
tonightnot|tonight not
tood|stood
tooked|looked
tookif|took if
tooking|looking
toolate|too late
toolike|too like
toom|loom
toothiessness|toothlessness
toowhile|too while
topossibly|to possibly
toppe|topped
topthis|top this
torchbeam|torch beam
torhbstone|tombstone
tornorrow|tomorrow
torpedoe|torpedoed
tossedoff|tossed off
totwo|to two
touch6|touche
touchand|touch and
touchedthe|touched the
toumament|tournament
touristscertainly|tourists certainly
towaffl|toward
towalk|to walk
towelsbut|towels but
towerwhat|tower what
towii|town
tpe|the
tprints|prints
tpulled|pulled
tqe|the
tq|to
tr1ed|tried
tracv|tracy
tradedfor|traded for
tradittions|traditions
trae|tracy
trafficcontrol|traffic control
trafticking|trafficking
traftic|traffic
trailmatic|traumatic
traming|training
translaters|translators
transportthat|transport that
trashdilapidated|trash dilapidated
trauing|trailing
travehng|traveling
traveledfar|traveled far
travelingfor|traveling for
travelingwhat|traveling what
trccs|trees
trce|tree
treasurefrom|treasure from
treasurethen|treasure then
treatmentfailed|treatment failed
trembg|trembling
triangularshaped|triangular shaped
triggersomeone|trigger someone
triie|true
tringes|fringes
trinuned|trimmed
tripleknotted|triple knotted
triumphandy|triumphantly
trjing|trying
troiii|from
trom|from
troopsthat|troops that
trottingjournalist|trotting journalist
troubk|trouble
troubleand|trouble and
troubleshear|troubles hear
troublethe|trouble the
troubletiuiilc|troubling
trough|through
trousersyour|trousers your
truckonce|truck once
trucksanything|trucks anything
trudi|truth
truethis|true this
trulv|truly
trumpedup|trumped up
truthbut|truth but
truthfurness|truthfulness
trving|trying
trv|try
tryiiig|trying
tself|itself
tsorry|sorry
ttds|this
ttee|tree
tte|the
ttfe|the
tthere|there
tthe|the
ttiat|that
ttiere|there
ttiey|they
ttie|the
ttleir|their
ttley|they
ttle|the
tto|to
ttwo|two
ttying|trying
tuckers|fuckers
tuesda|tuesday
tumabout|turn about
tumblerful|tumbler full
tumcoat|turncoat
tumed|turned
tumer|turner
tuming|turning
tumkeys|turnkeys
tumkey|turnkey
tumlng|turning
tumoff|turnoff
tumpikes|turnpikes
tumpike|turnpike
tumpoint|turn point
tums|turns
tumtable|turntable
tumultuousfirelight|tumultuous firelight
tum|turn
tunderstand|understand
tungs|lungs
tuniing|turning
tun|run
turged|turned
turiied|turned
turii|turn
turnedoffice|turned office
turnwith|turn with
turrups|turnips
tutnkeys|turnkeys
tuttgart|stuttgart
tvbat|what
tviarik|thank
tvmsting|twisting
twcnty|twenty
twelfthgrade|twelfth grade
twelvefoot|twelve foot
twelvegauge|twelve gage
twelvesimpson|twelve simpson
twelveyear|twelve year
twentics|twenties
twentydollar|twenty dollar
twicebom|twiceborn
twicesevering|twice severing
twillkling|twinkling
twinbrother|twin brother
twinengine|twin engine
twitchingbannister|twitching bannister
twnbling|tumbling
twoand|two and
twoby|two by
twodoing|two doing
twofull|two full
twoincome|two in come
twomasted|two masted
twominute|two minute
twoor|two or
twoparent|two parent
twoseater|two seater
twoseven|two seven
twostory|two story
twothings|two things
twoweek|two week
twozero|two zero
tws|this
txy|try
uaatch|watch
ucated|educated
uckled|chuckled
udfe|wife
udge|judge
udom|udorn
uestioncontinuing|question continuing
ufter|utter
uglybecause|ugly because
uiider|under
uiiheeded|unheeded
uiiited|united
uiitil|until
uith|with
ultiniatum|ultimatum
ultramodem|ultramodern
umnappedmountains|umnapped mountains
umnoved|unmoved
umon|union
umped|jumped
ump|jump
ums|urns
unadomed|unadorned
unaerstand|understand
unahle|unable
unannored|unarmored
unbearablefear|unbearable fear
unbhnldngly|unbelievingly
unbom|unborn
unbuckied|unbuckled
uncerwffly|uncertainly
unchauenging|unchallenging
unclassifi|unclassified
uncloudcd|unclouded
unconcemed|unconcerned
undcrstanding|understanding
undefinahle|undefinable
undemeath|underneath
undentand|understand
undercoverjobs|undercover jobs
underesfimated|underestimated
undergound|underground
understandyou|understand you
undiscoyered|undiscovered
undlerground|underground
undressedand|undressed and
unencumhered|unencumbered
unerstand|understand
unfavourable|unfavorable
unfil|until
unftiendly|unfriendly
ungxpectedly|unexpectedly
unhamessed|unharnessed
unhelievahle|unbelievable
uninistakable|unmistakable
uninretested|uninterested
unitedstates|united states
unitm|united
unknowingiy|unknowingly
unlcss|unless
unlikeiv|unlikely
unnoficed|unnoticed
unorgani|unorganized
unpamted|unpainted
unpredictablesometimes|unpredictable sometimes
unravelng|unraveling
unromfortable|uncomfortable
unseenand|unseen and
unsiiielded|unshielded
unsophlsticated|unsophisticated
unspofled|unspoiled
unsuccessftd|unsuccessful
unt5ll|until
unta|until
untfl|until
unthout|without
untilyesterday|until yesterday
untilyou|until you
untom|untorn
untrance|entrance
untu|until
unwelconiing|unwelcoming
upagainst|up against
upfiver|upriver
upheat|upbeat
uphffl|uphill
upliill|uphill
upoii|upon
upreme|supreme
upsetticing|upsetting
upthat|up that
upthe|up the
upto|up to
uptumed|upturned
uptum|upturn
upwelling|up welling
upwhich|up which
urchinsnot|urchins not
urdess|unless
urgenntly|urgently
urgeut|urgent
urnnercifully|unmercifully
ursuits|pursuits
usband|husband
usedfor|used for
usedthe|used the
usefiil|useful
usfeel|us feel
uslim|muslim
usout|us out
ussjohn|uss john
ustice|justice
ust|just
usuafly|usually
usuauy|usually
utelv|mutely
utes|minutes
utrerly|utterly
uty|duty
uwr|were
vaat|what
vaccinc|vaccine
vacuumsealed|vacuum sealed
vafley|valley
vaf|wife
vaginaand|vagina and
vagtielv|vaguely
vaidez|valdez
vaited|waited
valiies|values
valiie|value
valjlt|vault
vamish|varnish
vaney|valley
variedthan|varied than
varioiis|various
vathin|within
vaticanthis|vatican this
vattey|valley
vay|way
vebicles|vehicles
vechicle|vehicle
vegctables|vegetables
vehiclea|vehicle a
vellow|yellow
vemon|vernon
verage|coverage
verhead|overhead
verifv|verify
verry|very
versusfighter|versus fighter
verv|very
verybody|everybody
veryfast|very fast
veryfew|very few
veryfoul|very foul
veryglad|very glad
veryoutstanding|very outstanding
vestigated|investigated
vfllages|villages
vftat|what
vhat|what
vhen|when
vhere|where
vhich|which
vho|who
vhy|why
vicepresidency|vice presidency
vicepresident|vice president
victiin|victim
victimsand|victims and
victoryis|victory is
vidently|evidently
videocassettes|video cassettes
vietnarnization|vietnamization
vietnarn|vietnam
viewillg|viewing
vife|wife
viflage|village
vihat|what
villagewhich|village which
vincinity|vicinity
vineyardsfor|vineyards for
violencethe|violence the
violetand|violet and
vioman|woman
viously|obviously
viperstrike|viper strike
virtuafly|virtually
virusanimal|virus animal
virusthe|virus the
visas|was
vithout|without
vlhen|when
vlslon|vision
vmat|what
vnthout|without
voi6e|voice
voicecalled|voice called
voiir|your
voii|you
voil|you
voit|you
vold|void
voli|you
volurlteered|volunteered
volutionary|revolutionary
vomen|women
vould|would
vourself|yourself
vour|your
vou|you
vsas|was
vtas|was
vthehicles|vehicles
vulsively|impulsively
vvalll|wall
vvas|was
vvatched|watched
vvay|way
vvben|when
vveak|weak
vve|we
vvhat|what
vvho|who
vvhy|why
vvife|wife
vvith|with
vvlen|when
vvlhat|what
vvlhen|when
vvrhat|what
vwitche|switched
w4l|will
waed|wasted
waffing|warring
wafldng|walking
wafls|walls
wafl|wall
waiited|wanted
waiit|want
waikup|walkup
wailtop|walltop
waisted|wasted
waisthand|waistband
wais|was
waitedfor|waited for
waitfor|wait for
waitingfor|waiting for
waitmg|waiting
wajl|wall
wakc|wake
waldng|walking
walkaround|walk around
walkcd|walked
walkietalkie|walkie talkie
walkinguntil|walking until
walkino|walking
walkthrough|walk through
walldng|walking
walletsome|wallet some
walting|waiting
waltmg|waiting
wamed|warned
wamingly|warningly
wamings|warnings
waming|warming
waming|warning
wami|warm
wamors|warriors
wams|warns
wam|warn
wanderng|wandering
wanlone|was alone
wanned|warmed
wanning|warning
wans|walls
wantedand|wanted and
wantedfood|wanted food
wantedit|wanted it
wantedwhere|wanted where
wantsyou|wants you
wantthese|want these
wantyou|want you
wapons|weapons
war7n|warm
wardmichael|ward michael
warehousesful|warehouses full
warhogs|warthogs
warining|warming
warnbut|warn but
warnidg|warning
warni|warm
warriot|warrior
warshipsandnothingmore|warships and nothing more
warthog|wart hog
wartorn|war torn
warzone|war zone
wasa|was a
wasblue|was blue
wasbut|was but
wasdoing|was doing
wasfar|was for
wasfixed|was fixed
wasfor|was for
wasfurnished|was furnished
washingtoncivilian|washington civilian
wasjealously|was jealously
wasjohn|was john
wasjusttoo|was just to
wasjust|was just
waslittle|was little
wasli|wash
wasmostly|was mostly
wasno|was no
wasomthee|was om thee
wasor|was or
wasperhaps|was perhaps
wasraft|was raft
wastefil|wasteful
wasthis|was this
waswhat|was what
watchand|watch and
watchfive|watch five
watchlng|watching
waterbome|waterborne
watercould|water could
waterfrom|water from
waterjarring|water jarring
waterjust|water just
watersas|waters as
waterthe|water the
watrh|watch
waudng|walking
waus|walls
wavs|ways
wav|way
wayabout|way about
wayand|way and
wayfirst|way first
wayfor|way for
wayfrom|way from
waylots|way lots
waynext|way next
waypart|way part
wayreplenishment|way replenishment
waysgetting|ways getting
waytake|way take
waywom|wayworn
wbat|what
wbicb|which
wbo|who
wby|why
wcar|wear
wcll|well
wcrc|were
wcre|were
wc|we
wdifferently|differently
wdl|will
weadier|weather
weafiness|weariness
weai|wear
weanng|wearing
wearingjeans|wearing jeans
wearsleading|wears leading
weathera|weather a
weatherperson|weather person
wedgeshaped|wedge shaped
wednesdjly|wednesday
weekand|week and
weekendhe|weekend he
weekendsthat|weekends that
weeksnaturally|weeks naturally
weff|well
wefl|well
wefor|we for
wefound|we found
weftt|went
weh|well
weiit|went
weil|well
wejust|we just
welcomedpain|welcomed pain
welfarenothing|welfare nothing
welfarewhich|welfare which
welgh|weigh
weli|well
wellattended|well attended
wellchosen|well chosen
wellcrafted|well crafted
welldifferentiation|well differentiation
wellgive|well give
wellgroomed|well groomed
wellinformed|well informed
wellknown|well known
wellliked|well liked
wellmarked|well marked
wellmemorized|well memorized
wellpaying|well paying
wellprepared|well prepared
wellrespected|well respected
welltrained|well trained
welltreated|well treated
wented|wanted
wenty|twenty
wen|well
wer4e|were
werc|were
wereclosing|were closing
werefew|were few
werefilled|were filled
werefinished|were finished
werefollowing|were following
werejumbling|were jumbling
werejust|were just
werewith|were with
wer|well
westarted|we started
westefing|westering
westemmost|westernmost
westem|western
wetlandswhich|wetland swhich
weu|well
wffe|wife
wffl|will
wfiat|what
wfien|when
wfiispered|whispered
wfist|wrist
wfldly|wildly
wfld|wild
wfli|will
wflls|wills
whai|what
wharnming|whamming
whatare|what are
whatartificial|what artificial
whatevercan|whatever can
whateverpaid|whatever paid
whateverthey|whatever they
whateverthe|whatever the
whatfalls|what falls
whathalf|what half
whathe|what he
whatlooked|what looked
whatwhat|what what
whatyou|what you
whcrc|where
whde|while
wheceas|whereas
wheceby|whereby
whecein|wherein
wheelied|wheeled
wheii|when
whenhis|when his
wherc|where
wher|where
whfle|while
whfte|white
whg|willing
whi6re|where
whicb|which
whichnow|which now
whichtrust|which trust
whiie|while
whilc|while
whinnv|whinny
whiskeyamber|whiskey amber
whitc|white
whiteno|white no
whitestriped|white striped
whiting|waiting
whi|will
whoeverdelivers|whoever delivers
whofelt|who felt
whois|who is
wholc|whole
wholefleet|whole fleet
whoni|whom
whothe|who the
whowithout|who without
whowith|who with
whoyou|who you
whtch|which
whue|while
whv|why
whyjack|why jack
whyyour|why your
whyyou|why you
widebodies|wide bodies
wifliams|williams
wifliam|william
wifling|willing
wifl|will
wiishington|washington
wildemess|wilderness
wilderbess|wilderness
wilere|where
wiley|wile y
wilf|will
wili|will
willch|winch
willfind|will find
williani|william
wimng|willing
windbom|windborn
windfrom|wind from
windotvs|windows
windowswhich|windows which
winginan|wingman
wingnian|wingman
winidow|window
winldng|winking
wintertelling|winter telling
wiredestroying|were destroying
wireguided|wire guided
wirik|wink
wirling|whirling
wisewoman|wise woman
wishftil|wishful
wis|was
witbin|within
witb|with
witfi|with
withanyone|with anyone
witha|with a
withfriends|with friends
withgut|without
withiii|within
withinnocent|with innocent
withjust|with just
withno|with no
withoiit|without
withoutnotice|without notice
withut|without
witigs|wings
witn|with
wittout|without
wiuin|willing
wiu|will
wix|will
wjth|with
wkat|what
wlfc|wife
wlffle|while
wlfl|will
wlhat|what
wliat|what
wliere|where
wliip|whip
wllispers|whispers
wlre|wire
wlthln|within
wlth|with
wluch|which
wlute|white
wlu|will
wmdows|windows
wmd|wind
wmpped|wrapped
wnat|what
wnere|where
wne|same
wnfidence|confidence
wnong|among
wnte|white
wnw|own
woamn|woman
woifld|would
woiild|would
wolftnan|wolfman
wolild|would
wolvesnobody|wolves nobody
womaii|woman
womanwas|woman was
womanwould|woman would
womcn|women
womeii|women
womento|women to
womqn|women
womw|woman
wom|worn
wondefful|wonderful
wonderfiilly|wonderfully
wonderftd|wonderful
wonh|worth
wonian|woman
wony|worry
worc|wore
wordfor|word for
wordiessly|wordlessly
wordi|worth
wordof|word of
wordsthen|words then
worfd|world
worfied|worried
worid|world
woried|worried
workedall|worked all
workiiig|working
workmay|work may
workmoney|work money
workover|work over
worlc|work
worldclass|world class
worldfor|world for
worldfull|world full
worldgrapes|world grapes
worldhealing|world healing
worldng|working
worldthere|world there
wornain|woman
wornan|woman
worriedven|worried even
worryit|worry it
worstcase|worst case
wortied|worried
wotdd|would
wotfld|would
wotgd|would
wotidcr|wonder
wotid|would
wotufered|wondered
wouid|would
woulcl|would
wouldit|would it
wouldof|would of
wouldwas|would was
woundsand|wound sand
woutd|would
wo|we
wps|was
wqre|were
wrinkied|wrinkled
writingwhatever|writing whatever
writteii|written
wrongclark|wrong clark
wrongif|wrong if
ws|his
wtfe|wife
wthout|without
wth|with
wtitten|written
wtorn|torn
wudly|wildly
wuiting|waiting
wul|will
wwere|were
wwill|will
wx|will
xactly|exactly
xamine|examine
xandre|alexandre
xcuse|excuse
xercises|exercises
xhausted|exhausted
xpected|expected
xplained|explained
xploded|exploded
xposed|exposed
xvere|were
xvith|with
y6u|you
yankec|yankee
yankedwhich|yanked which
ybody|body
ycars|years
ycllow|yellow
ydu|you
yeai|year
yeamed|yearned
yeaming|yearning
yearabout|year about
yeara|year a
yearsof|years of
yearspassed|years passed
yearwood|year wood
yeem|seem
yeffin|yelling
yeflow|yellow
yeilow|yellow
yellowbrown|yellow brown
yellowthe|yellow the
yem|year
yesthere|yes there
yft|yet
yingdom|kingdom
yjung|young
ynderstands|understands
yoa|you
yoif|your
yoiing|young
yoii|you
yoil|you
yoit|you
yoli|you
yoll|you
yoq|you
yotir|your
yoti|you
yotl|you
yott|you
youand|you and
youask|you ask
youcan|you can
youchicken|you chicken
youdone|you done
youfrom|you from
youfrown|you frown
yougot|you got
youhavetheopportunity|you have the opportunity
youhey|you hey
youiig|young
youi|you
youknow|you know
youn|young
yourbest|your best
yourfather|your father
yourfriends|your friends
yourfucking|your fucking
yourjob|your job
yourprotection|your protection
yoursbe|yours be
yourseft|yourself
yoursef|yourself
yourseit|yourself
yourselt|yourself
yoursel|yourself
yourserf|yourself
youstart|you start
youthftll|youthful
youwhat|you what
youwish|you wish
yov|you
ypur|your
yqars|years
yqu|you
ystems|systems
ything|anything
yucatfin|yucatan
yway|way
zer0|zero
zeroseven|zero seven
zight|sight
zlooked|looked
zmmediately|immediately
zncomprehensible|incomprehensible
zncrease|increase
znes|lines
znstructed|instructed
zntelligence|intelligence
znvolved|involved
zn|in
zometlmes|sometimes
zonc|zone
zonemostly|sone mostly
zoorn|zoom
zure|sure
